1,Alex Abrines\abrinal01,SG,25,OKC,31,2,588,56,157,.357,41,127,.323,15,30,.500,.487,12,13,.923,5,43,48,20,17,6,14,53,165
2,Quincy Acy\acyqu01,PF,28,PHO,10,0,123,4,18,.222,2,15,.133,2,3,.667,.278,7,10,.700,3,22,25,8,1,4,4,24,17
3,Jaylen Adams\adamsja01,PG,22,ATL,10,0,45,4,12,.333,3,7,.429,1,5,.200,.458,2,2,1.000,1,3,4,6,3,1,2,4,13
4,Steven Adams\adamsst01,C,25,OKC,55,55,1866,345,568,.607,0,1,.000,345,567,.608,.607,120,218,.550,248,273,521,91,86,42,89,139,810
5,Bam Adebayo\adebaba01,C,21,MIA,56,6,1236,164,292,.562,1,9,.111,163,283,.576,.563,110,153,.719,115,259,374,110,42,42,80,140,439
6,Deng Adel\adelde01,SF,21,CLE,12,3,158,9,30,.300,5,20,.250,4,10,.400,.383,2,2,1.000,2,11,13,4,1,4,5,11,25
7,DeVaughn Akoon-Purcell\akoonde01,SG,25,DEN,7,0,22,3,10,.300,0,4,.000,3,6,.500,.300,1,2,.500,1,3,4,6,2,0,2,4,7
8,LaMarcus Aldridge\aldrila01,C,33,SAS,58,58,1896,476,935,.509,5,23,.217,471,912,.516,.512,261,309,.845,182,340,522,148,30,70,109,129,1218
9,Rawle Alkins\alkinra01,SG,21,CHI,3,0,6,1,4,.250,1,1,1.000,0,3,.000,.375,0,0,,3,0,3,2,1,0,0,1,3
10,Grayson Allen\allengr01,SG,23,UTA,28,1,276,34,109,.312,19,69,.275,15,40,.375,.399,27,36,.750,1,10,11,17,4,3,16,30,114
11,Jarrett Allen\allenja01,C,20,BRK,57,57,1538,246,430,.572,6,37,.162,240,393,.611,.579,141,191,.738,147,345,492,87,33,91,78,128,639
12,Kadeem Allen\allenka01,SG,26,NYK,10,1,225,37,76,.487,8,16,.500,29,60,.483,.539,19,26,.731,5,24,29,45,8,1,11,26,101
13,Al-Farouq Aminu\aminual01,PF,28,POR,57,57,1655,178,409,.435,73,204,.358,105,205,.512,.524,107,126,.849,86,364,450,75,50,21,46,110,536
14,Justin Anderson\anderju01,SF,25,ATL,30,0,243,32,84,.381,8,40,.200,24,44,.545,.429,16,21,.762,11,33,44,12,11,7,13,28,88
15,Kyle Anderson\anderky01,SF,25,MEM,43,40,1281,150,276,.543,9,34,.265,141,242,.583,.560,37,64,.578,48,203,251,128,54,37,58,112,346
16,Ryan Anderson\anderry01,PF,30,TOT,16,8,280,19,60,.317,7,34,.206,12,26,.462,.375,11,14,.786,14,31,45,18,3,1,12,23,56
16,Ryan Anderson\anderry01,PF,30,PHO,15,8,278,19,60,.317,7,34,.206,12,26,.462,.375,11,14,.786,14,31,45,17,3,1,12,23,56
16,Ryan Anderson\anderry01,PF,30,MIA,1,0,2,0,0,,0,0,,0,0,,,0,0,,0,0,0,1,0,0,0,0,0
17,Ike Anigbogu\anigbik01,C,20,IND,3,0,6,0,3,.000,0,0,,0,3,.000,.000,0,0,,1,2,3,1,0,1,1,0,0
18,Giannis Antetokounmpo\antetgi01,PF,24,MIL,53,53,1757,531,914,.581,29,130,.223,502,784,.640,.597,349,487,.717,124,549,673,317,75,76,204,180,1440
19,Carmelo Anthony\anthoca01,PF,34,HOU,10,2,294,49,121,.405,21,64,.328,28,57,.491,.492,15,22,.682,9,45,54,5,4,7,8,32,134
20,OG Anunoby\anunoog01,SF,21,TOR,48,5,976,136,307,.443,52,156,.333,84,151,.556,.528,19,42,.452,37,110,147,33,32,11,34,106,343
21,Ryan Arcidiacono\arcidry01,PG,24,CHI,57,25,1402,107,258,.415,61,169,.361,46,89,.517,.533,47,52,.904,14,122,136,204,54,2,46,121,322
22,Trevor Ariza\arizatr01,SF,33,TOT,54,54,1910,235,592,.397,118,352,.335,117,240,.488,.497,100,124,.806,35,266,301,207,81,13,88,104,688
22,Trevor Ariza\arizatr01,SF,33,PHO,26,26,884,86,227,.379,50,139,.360,36,88,.409,.489,36,43,.837,16,129,145,87,38,8,39,44,258
22,Trevor Ariza\arizatr01,SF,33,WAS,28,28,1026,149,365,.408,68,213,.319,81,152,.533,.501,64,81,.790,19,137,156,120,43,5,49,60,430
23,D.J. Augustin\augusdj01,PG,31,ORL,58,58,1605,211,452,.467,92,216,.426,119,236,.504,.569,145,166,.873,28,97,125,284,33,1,87,82,659
24,Deandre Ayton\aytonde01,C,20,PHO,53,52,1639,386,657,.588,0,4,.000,386,653,.591,.588,105,136,.772,166,390,556,104,42,49,96,151,877
25,Dwayne Bacon\bacondw01,SG,23,CHO,25,0,265,44,84,.524,13,25,.520,31,59,.525,.601,10,12,.833,3,36,39,17,3,1,12,28,111
26,Marvin Bagley\baglema01,PF,19,SAC,43,1,1040,221,429,.515,14,55,.255,207,374,.553,.531,115,168,.685,100,196,296,41,23,42,70,89,571
27,Ron Baker\bakerro01,SG,25,TOT,15,0,152,4,20,.200,1,13,.077,3,7,.429,.225,5,6,.833,1,10,11,15,6,1,5,18,14
27,Ron Baker\bakerro01,SG,25,NYK,11,0,107,4,16,.250,1,9,.111,3,7,.429,.281,5,6,.833,1,6,7,13,5,0,3,16,14
27,Ron Baker\bakerro01,SG,25,WAS,4,0,45,0,4,.000,0,4,.000,0,0,,.000,0,0,,0,4,4,2,1,1,2,2,0
28,Wade Baldwin\baldwwa01,PG,22,POR,16,0,94,10,33,.303,2,9,.222,8,24,.333,.333,8,11,.727,2,13,15,12,1,2,14,11,30
29,Lonzo Ball\balllo01,PG,21,LAL,47,45,1423,185,456,.406,75,228,.329,110,228,.482,.488,20,48,.417,54,197,251,255,69,19,103,114,465
30,Mohamed Bamba\bambamo01,C,20,ORL,47,1,766,117,243,.481,21,70,.300,96,173,.555,.525,37,63,.587,64,169,233,39,13,64,43,102,292
31,J.J. Barea\bareajo01,PG,34,DAL,38,0,752,161,385,.418,38,128,.297,123,257,.479,.468,55,78,.705,13,82,95,211,22,1,72,50,415
32,Harrison Barnes\barneha02,PF-SF,26,TOT,52,52,1692,303,754,.402,127,331,.384,176,423,.416,.486,173,206,.840,40,189,229,71,37,11,73,85,906
32,Harrison Barnes\barneha02,PF,26,DAL,49,49,1584,290,717,.404,121,311,.389,169,406,.416,.489,165,198,.833,36,171,207,62,33,11,68,79,866
32,Harrison Barnes\barneha02,SF,26,SAC,3,3,108,13,37,.351,6,20,.300,7,17,.412,.432,8,8,1.000,4,18,22,9,4,0,5,6,40
33,Will Barton\bartowi01,SG,28,DEN,18,13,479,79,193,.409,28,78,.359,51,115,.443,.482,31,39,.795,17,63,80,62,5,10,27,36,217
34,Keita Bates-Diop\bateske01,SF,23,MIN,6,0,34,3,11,.273,0,5,.000,3,6,.500,.273,0,2,.000,0,6,6,0,0,1,1,2,6
35,Nicolas Batum\batumni01,SF,30,CHO,57,57,1778,193,420,.460,81,210,.386,112,210,.533,.556,62,73,.849,51,246,297,191,55,31,92,102,529
36,Jerryd Bayless\bayleje01,PG,30,MIN,19,6,403,47,141,.333,23,70,.329,24,71,.338,.415,7,12,.583,7,31,38,75,10,1,19,32,124
37,Aron Baynes\baynear01,C,32,BOS,34,10,507,69,148,.466,16,48,.333,53,100,.530,.520,39,46,.848,60,87,147,38,6,22,28,82,193
38,Kent Bazemore\bazemke01,SG,29,ATL,44,30,1122,209,476,.439,61,192,.318,148,284,.521,.503,95,131,.725,23,144,167,108,69,36,87,115,574
39,Bradley Beal\bealbr01,SG,25,WAS,58,58,2158,535,1134,.472,145,416,.349,390,718,.543,.536,243,298,.815,66,228,294,311,82,44,167,173,1458
40,Malik Beasley\beaslma01,SG,22,DEN,57,14,1371,262,521,.503,119,275,.433,143,246,.581,.617,39,44,.886,22,121,143,68,38,6,34,88,682
41,Michael Beasley\beaslmi01,PF,30,LAL,26,2,277,75,153,.490,3,17,.176,72,136,.529,.500,28,39,.718,13,47,60,25,9,10,27,42,181
42,Marco Belinelli\belinma01,SG,32,SAS,57,1,1295,210,502,.418,111,288,.385,99,214,.463,.529,92,100,.920,11,121,132,109,28,8,50,91,623
43,Jordan Bell\belljo01,C,24,GSW,48,2,531,64,124,.516,0,1,.000,64,123,.520,.516,14,21,.667,38,88,126,56,16,36,24,58,142
44,DeAndre' Bembry\bembrde01,SG,24,ATL,58,15,1412,186,434,.429,37,129,.287,149,305,.489,.471,55,89,.618,31,206,237,145,72,30,101,137,464
45,Dragan Bender\bendedr01,PF,21,PHO,24,7,301,34,84,.405,7,45,.156,27,39,.692,.446,16,24,.667,16,52,68,21,5,3,16,28,91
46,Davis Bertans\bertada01,PF,26,SAS,53,10,1130,148,305,.485,109,229,.476,39,76,.513,.664,35,40,.875,18,166,184,66,28,26,32,91,440
47,Patrick Beverley\beverpa01,PG,30,LAC,59,30,1579,136,341,.399,77,201,.383,59,140,.421,.512,80,103,.777,49,226,275,208,46,31,62,203,429
48,Khem Birch\birchkh01,C,26,ORL,27,0,293,36,61,.590,0,1,.000,36,60,.600,.590,23,28,.821,28,59,87,18,9,18,8,27,95
49,Bismack Biyombo\biyombi01,C,26,CHO,31,17,470,51,90,.567,0,0,,51,90,.567,.567,35,54,.648,47,103,150,18,8,34,18,63,137
50,Nemanja Bjelica\bjeline01,PF,30,SAC,56,55,1307,211,437,.483,81,192,.422,130,245,.531,.576,52,68,.765,93,230,323,109,41,45,69,144,555
51,Antonio Blakeney\blakean01,SG,22,CHI,42,0,580,120,284,.423,32,70,.457,88,214,.411,.479,38,56,.679,6,59,65,23,10,8,25,26,310
52,Eric Bledsoe\bledser01,PG,29,MIL,56,56,1630,339,689,.492,87,271,.321,252,418,.603,.555,121,158,.766,55,198,253,303,83,22,116,120,886
53,Jaron Blossomgame\blossja01,SF,25,CLE,27,4,439,47,106,.443,10,39,.256,37,67,.552,.491,10,13,.769,26,72,98,13,7,8,11,20,114
54,Bogdan Bogdanovic\bogdabo01,SG,26,SAC,45,9,1258,247,582,.424,82,247,.332,165,335,.493,.495,92,114,.807,21,141,162,180,48,10,80,88,668
55,Bojan Bogdanovic\bogdabo02,SF,29,IND,58,58,1845,350,708,.494,115,270,.426,235,438,.537,.576,159,192,.828,28,203,231,104,48,0,90,101,974
56,Jonah Bolden\boldejo01,PF,23,PHI,28,3,350,41,84,.488,15,47,.319,26,37,.703,.577,8,18,.444,25,73,98,17,8,24,23,59,105
57,Isaac Bonga\bongais01,PG,19,LAL,8,0,31,2,10,.200,0,2,.000,2,8,.250,.200,4,7,.571,3,3,6,6,3,0,2,3,8
58,Devin Booker\bookede01,SG,22,PHO,44,44,1529,381,828,.460,91,280,.325,290,548,.529,.515,228,269,.848,26,148,174,293,39,8,171,143,1081
59,Chris Boucher\bouchch01,PF,26,TOR,17,0,93,22,48,.458,10,25,.400,12,23,.522,.563,11,13,.846,11,17,28,0,3,16,2,17,65
60,Avery Bradley\bradlav01,SG,28,TOT,52,52,1554,186,463,.402,64,183,.350,122,280,.436,.471,20,25,.800,35,104,139,109,30,16,68,138,456
60,Avery Bradley\bradlav01,SG,28,LAC,49,49,1463,161,420,.383,58,172,.337,103,248,.415,.452,20,25,.800,35,96,131,96,27,16,61,133,400
60,Avery Bradley\bradlav01,SG,28,MEM,3,3,91,25,43,.581,6,11,.545,19,32,.594,.651,0,0,,0,8,8,13,3,0,7,5,56
61,Tony Bradley\bradlto01,C,21,UTA,1,0,9,0,3,.000,0,0,,0,3,.000,.000,0,0,,2,1,3,0,0,0,1,1,0
62,Corey Brewer\breweco01,SF,32,PHI,7,3,140,20,49,.408,4,14,.286,16,35,.457,.449,9,13,.692,4,13,17,10,12,2,8,16,53
63,Mikal Bridges\bridgmi01,SF,22,PHO,59,45,1643,173,399,.434,81,230,.352,92,169,.544,.535,57,73,.781,40,144,184,104,91,30,48,145,484
64,Miles Bridges\bridgmi02,SF,20,CHO,55,0,1042,138,309,.447,38,123,.309,100,186,.538,.508,43,59,.729,32,159,191,54,28,35,33,69,357
65,Isaiah Briscoe\briscis01,PG,22,ORL,34,0,455,42,109,.385,10,27,.370,32,82,.390,.431,9,18,.500,2,58,60,75,8,1,24,55,103
66,Ryan Broekhoff\broekry01,SG,28,DAL,26,0,209,28,63,.444,19,49,.388,9,14,.643,.595,2,2,1.000,3,24,27,14,2,3,5,15,77
67,Malcolm Brogdon\brogdma01,SG,26,MIL,53,53,1548,317,627,.506,80,196,.408,237,431,.550,.569,121,129,.938,54,198,252,175,39,12,80,86,835
68,Dillon Brooks\brookdi01,SF,23,MEM,18,0,330,49,122,.402,15,40,.375,34,82,.415,.463,22,30,.733,9,22,31,16,10,4,19,50,135
69,MarShon Brooks\brookma01,SG,30,MEM,29,0,387,76,169,.450,15,54,.278,61,115,.530,.494,23,33,.697,12,33,45,25,9,4,21,33,190
70,Bruce Brown\brownbr01,SG,22,DET,49,31,970,89,231,.385,19,71,.268,70,160,.438,.426,31,45,.689,33,100,133,64,21,23,35,123,228
71,Jaylen Brown\brownja02,SG,22,BOS,53,23,1376,258,573,.450,62,196,.316,196,377,.520,.504,96,141,.681,53,174,227,71,49,26,72,138,674
72,Lorenzo Brown\brownlo01,PG,28,TOR,26,0,212,23,71,.324,6,28,.214,17,43,.395,.366,3,3,1.000,5,26,31,28,12,5,16,22,55
73,Sterling Brown\brownst02,SG,23,MIL,46,0,745,95,210,.452,40,110,.364,55,100,.550,.548,18,25,.720,24,109,133,58,18,5,31,63,248
74,Troy Brown\browntr01,SF,19,WAS,29,0,208,26,65,.400,4,15,.267,22,50,.440,.431,14,21,.667,5,34,39,27,8,1,8,16,70
75,Jalen Brunson\brunsja01,PG,22,DAL,49,16,887,130,301,.432,31,90,.344,99,211,.469,.483,40,60,.667,14,86,100,119,23,2,47,69,331
76,Thomas Bryant\bryanth01,C,21,WAS,48,42,916,192,301,.638,18,47,.383,174,254,.685,.668,62,76,.816,67,208,275,54,16,38,33,75,464
77,Reggie Bullock\bullore01,SG,27,TOT,46,46,1421,189,457,.414,117,302,.387,72,155,.465,.542,56,64,.875,20,109,129,113,27,8,55,82,551
77,Reggie Bullock\bullore01,SG,27,DET,44,44,1355,182,441,.413,114,294,.388,68,147,.463,.542,56,64,.875,20,103,123,109,24,5,54,79,534
77,Reggie Bullock\bullore01,SG,27,LAL,2,2,66,7,16,.438,3,8,.375,4,8,.500,.531,0,0,,0,6,6,4,3,3,1,3,17
78,Trey Burke\burketr01,PG,26,TOT,38,7,763,159,384,.414,35,96,.365,124,288,.431,.460,69,83,.831,17,52,69,105,27,5,37,39,422
78,Trey Burke\burketr01,PG,26,NYK,33,7,689,148,358,.413,30,86,.349,118,272,.434,.455,62,75,.827,15,47,62,94,21,5,29,33,388
78,Trey Burke\burketr01,PG,26,DAL,5,0,74,11,26,.423,5,10,.500,6,16,.375,.519,7,8,.875,2,5,7,11,6,0,8,6,34
79,Alec Burks\burksal01,SG,27,TOT,54,24,1291,187,460,.407,61,163,.374,126,297,.424,.473,113,137,.825,29,193,222,121,32,20,62,84,548
79,Alec Burks\burksal01,SG,27,UTA,17,0,269,47,114,.412,16,43,.372,31,71,.437,.482,33,38,.868,2,25,27,20,6,4,15,22,143
79,Alec Burks\burksal01,SG,27,CLE,34,24,979,136,340,.400,45,119,.378,91,221,.412,.466,79,98,.806,26,160,186,98,25,16,46,62,396
79,Alec Burks\burksal01,SG,27,SAC,3,0,43,4,6,.667,0,1,.000,4,5,.800,.667,1,1,1.000,1,8,9,3,1,0,1,0,9
80,Deonte Burton\burtode02,SG,25,OKC,20,0,187,28,60,.467,7,20,.350,21,40,.525,.525,6,8,.750,3,18,21,7,4,8,8,25,69
81,Jimmy Butler\butleji01,SF-SG,29,TOT,46,46,1540,310,643,.482,56,151,.371,254,492,.516,.526,214,249,.859,76,157,233,180,94,27,63,79,890
81,Jimmy Butler\butleji01,SG,29,MIN,10,10,361,74,157,.471,17,45,.378,57,112,.509,.525,48,61,.787,16,36,52,43,24,10,14,18,213
81,Jimmy Butler\butleji01,SF,29,PHI,36,36,1179,236,486,.486,39,106,.368,197,380,.518,.526,166,188,.883,60,121,181,137,70,17,49,61,677
82,Bruno Caboclo\cabocbr01,SF,23,MEM,11,1,222,22,61,.361,11,39,.282,11,22,.500,.451,14,14,1.000,10,27,37,10,5,14,9,28,69
83,Jose Calderon\caldejo01,PG,37,DET,46,0,621,45,118,.381,14,56,.250,31,62,.500,.441,9,11,.818,9,47,56,113,16,3,35,63,113
84,Kentavious Caldwell-Pope\caldwke01,SG,25,LAL,57,12,1368,201,464,.433,93,267,.348,108,197,.548,.533,91,107,.850,33,124,157,63,49,8,39,88,586
85,Isaiah Canaan\canaais01,PG,27,TOT,26,16,598,62,158,.392,32,91,.352,30,67,.448,.494,19,24,.792,5,49,54,81,14,1,33,50,175
85,Isaiah Canaan\canaais01,PG,27,PHO,19,15,503,51,129,.395,25,72,.347,26,57,.456,.492,15,20,.750,5,44,49,62,12,0,29,46,142
85,Isaiah Canaan\canaais01,PG,27,MIN,7,1,95,11,29,.379,7,19,.368,4,10,.400,.500,4,4,1.000,0,5,5,19,2,1,4,4,33
86,Clint Capela\capelca01,C,24,HOU,42,42,1436,315,499,.631,0,0,,315,499,.631,.631,109,174,.626,208,320,528,62,25,77,65,112,739
87,DeMarre Carroll\carrode01,SF,32,BRK,46,0,1181,156,404,.386,72,209,.344,84,195,.431,.475,132,176,.750,48,189,237,62,24,7,52,73,516
88,Jevon Carter\carteje01,PG,23,MEM,25,3,381,26,107,.243,13,56,.232,13,51,.255,.304,8,13,.615,5,30,35,45,21,8,22,38,73
89,Vince Carter\cartevi01,SF,42,ATL,53,8,838,124,289,.429,74,191,.387,50,98,.510,.557,24,36,.667,22,114,136,51,30,17,34,92,346
90,Wendell Carter\cartewe01,C,19,CHI,44,44,1110,180,371,.485,6,32,.188,174,339,.513,.493,89,112,.795,87,220,307,78,26,58,65,152,455
91,Michael Carter-Williams\cartemi01,PG,27,HOU,16,1,145,25,61,.410,7,19,.368,18,42,.429,.467,12,26,.462,3,10,13,21,9,6,10,27,69
92,Alex Caruso\carusal01,PG,24,LAL,5,0,20,2,4,.500,1,1,1.000,1,3,.333,.625,1,4,.250,1,0,1,1,0,2,0,3,6
93,Omri Casspi\casspom01,SF,30,MEM,36,0,520,86,161,.534,15,43,.349,71,118,.602,.581,39,58,.672,17,98,115,26,20,9,23,35,226
94,Willie Cauley-Stein\caulewi01,C,25,SAC,57,57,1601,308,571,.539,1,2,.500,307,569,.540,.540,107,196,.546,138,347,485,148,72,39,69,174,724
95,Troy Caupain\caupatr01,PG,23,ORL,2,0,9,2,4,.500,1,2,.500,1,2,.500,.625,0,0,,0,2,2,3,1,0,0,0,5
96,Tyler Cavanaugh\cavanty01,PF,24,UTA,8,0,19,2,6,.333,0,3,.000,2,3,.667,.333,2,2,1.000,1,3,4,0,0,0,1,0,6
97,Tyson Chandler\chandty01,C,36,TOT,48,6,813,59,97,.608,0,1,.000,59,96,.615,.608,48,81,.593,90,201,291,34,20,22,36,103,166
97,Tyson Chandler\chandty01,C,36,PHO,7,0,89,8,12,.667,0,0,,8,12,.667,.667,10,18,.556,7,32,39,6,2,1,7,21,26
97,Tyson Chandler\chandty01,C,36,LAL,41,6,724,51,85,.600,0,1,.000,51,84,.607,.600,38,63,.603,83,169,252,28,18,21,29,82,140
98,Wilson Chandler\chandwi01,PF,31,PHI,36,32,951,91,207,.440,46,118,.390,45,89,.506,.551,13,18,.722,44,124,168,72,22,18,39,94,241
99,Joe Chealey\chealjo01,PG,23,CHO,1,0,8,1,3,.333,0,0,,1,3,.333,.333,0,0,,0,0,0,1,0,0,0,1,2
100,Marquese Chriss\chrisma01,PF,21,TOT,20,1,201,33,75,.440,10,31,.323,23,44,.523,.507,10,12,.833,14,39,53,10,6,4,17,30,86
100,Marquese Chriss\chrisma01,PF,21,HOU,16,0,104,11,34,.324,1,15,.067,10,19,.526,.338,6,7,.857,7,21,28,6,2,4,12,17,29
100,Marquese Chriss\chrisma01,PF,21,CLE,4,1,97,22,41,.537,9,16,.563,13,25,.520,.646,4,5,.800,7,18,25,4,4,0,5,13,57
101,Gary Clark\clarkga01,PF,24,HOU,37,1,528,35,110,.318,29,100,.290,6,10,.600,.450,6,6,1.000,18,76,94,14,15,22,5,38,105
102,Ian Clark\clarkia01,SG,27,NOP,41,0,535,70,177,.395,31,90,.344,39,87,.448,.483,14,15,.933,6,45,51,48,7,4,36,53,185
103,Jordan Clarkson\clarkjo01,SG,26,CLE,57,0,1542,383,854,.448,108,322,.335,275,532,.517,.512,106,127,.835,55,142,197,139,42,11,98,86,980
104,John Collins\collijo01,PF,21,ATL,42,40,1248,319,556,.574,37,103,.359,282,453,.623,.607,128,171,.749,149,250,399,87,13,17,88,141,803
105,Zach Collins\colliza01,C,21,POR,57,0,1035,141,298,.473,30,88,.341,111,210,.529,.523,75,96,.781,82,163,245,54,22,47,57,142,387
106,Darren Collison\collida01,PG,31,IND,58,58,1626,227,482,.471,61,147,.415,166,335,.496,.534,96,117,.821,26,144,170,342,83,8,88,102,611
107,Mike Conley\conlemi01,PG,31,MEM,56,56,1875,378,886,.427,120,339,.354,258,547,.472,.494,241,284,.849,34,158,192,358,78,18,104,95,1117
108,Pat Connaughton\connapa01,SG,26,MIL,37,1,626,84,192,.438,32,111,.288,52,81,.642,.521,15,22,.682,28,93,121,68,16,15,18,40,215
109,Quinn Cook\cookqu01,PG,25,GSW,49,8,705,134,300,.447,50,134,.373,84,166,.506,.530,15,20,.750,16,93,109,82,17,3,32,66,333
110,DeMarcus Cousins\couside01,C,28,GSW,11,11,257,50,118,.424,9,31,.290,41,87,.471,.462,44,60,.733,13,62,75,41,14,12,23,40,153
111,Robert Covington\covinro01,SF,28,TOT,35,35,1203,156,362,.431,85,225,.378,71,137,.518,.548,68,89,.764,28,165,193,46,74,47,47,126,465
111,Robert Covington\covinro01,SF,28,PHI,13,13,440,50,117,.427,30,77,.390,20,40,.500,.556,17,23,.739,7,60,67,14,24,23,22,45,147
111,Robert Covington\covinro01,SF,28,MIN,22,22,763,106,245,.433,55,148,.372,51,97,.526,.545,51,66,.773,21,105,126,32,50,24,25,81,318
112,Allen Crabbe\crabbal01,SG,26,BRK,32,15,831,105,285,.368,79,195,.405,26,90,.289,.507,36,47,.766,13,95,108,34,20,9,35,76,325
113,Torrey Craig\craigto01,SF,28,DEN,52,37,1166,120,276,.435,41,139,.295,79,137,.577,.509,32,50,.640,73,130,203,49,28,33,38,127,313
114,Jamal Crawford\crawfja01,SG,38,PHO,49,0,864,108,295,.366,38,133,.286,70,162,.432,.431,58,71,.817,7,52,59,166,22,9,72,58,312
115,Mitch Creek\creekmi01,SF,26,BRK,4,0,36,5,10,.500,0,1,.000,5,9,.556,.500,5,7,.714,5,5,10,5,1,0,0,3,15
116,Jae Crowder\crowdja01,SF,28,UTA,56,8,1536,218,555,.393,122,366,.333,96,189,.508,.503,105,152,.691,45,219,264,91,44,21,65,118,663
117,Dante Cunningham\cunnida01,PF,31,SAS,53,21,845,71,142,.500,30,60,.500,41,82,.500,.606,13,16,.813,45,133,178,48,23,13,21,66,185
118,Seth Curry\curryse01,SG,28,POR,51,2,879,118,267,.442,66,142,.465,52,125,.416,.566,15,17,.882,16,57,73,50,19,7,35,69,317
119,Stephen Curry\curryst01,PG,30,GSW,46,46,1576,440,901,.488,236,531,.444,204,370,.551,.619,200,217,.922,32,204,236,240,56,18,128,118,1316
120,Troy Daniels\danietr01,SG,27,PHO,29,0,383,57,140,.407,39,103,.379,18,37,.486,.546,12,16,.750,6,25,31,9,16,2,18,39,165
121,Anthony Davis\davisan02,C,25,NOP,45,45,1618,451,888,.508,41,127,.323,410,761,.539,.531,323,399,.810,142,438,580,189,73,114,88,116,1266
122,Ed Davis\davised01,C,29,BRK,58,1,1061,138,224,.616,0,2,.000,138,222,.622,.616,66,113,.584,163,337,500,48,29,27,49,161,342
123,Tyler Davis\davisty01,C,21,OKC,1,0,1,0,1,.000,0,0,,0,1,.000,.000,0,0,,1,0,1,0,0,0,0,0,0
124,Dewayne Dedmon\dedmode01,C,29,ATL,48,37,1189,188,385,.488,63,162,.389,125,223,.561,.570,68,79,.861,73,264,337,63,47,47,68,162,507
125,Sam Dekker\dekkesa01,SF-PF,24,TOT,35,5,598,99,199,.497,13,42,.310,86,157,.548,.530,18,30,.600,41,80,121,33,31,7,17,36,229
125,Sam Dekker\dekkesa01,PF,24,CLE,9,5,169,22,48,.458,5,13,.385,17,35,.486,.510,8,10,.800,9,24,33,9,11,0,5,13,57
125,Sam Dekker\dekkesa01,SF,24,WAS,26,0,429,77,151,.510,8,29,.276,69,122,.566,.536,10,20,.500,32,56,88,24,20,7,12,23,172
126,Angel Delgado\delgaan01,C,24,LAC,1,0,14,1,4,.250,0,0,,1,4,.250,.250,1,2,.500,2,2,4,0,1,0,0,2,3
127,Matthew Dellavedova\dellama01,PG,28,TOT,41,0,681,86,204,.422,39,109,.358,47,95,.495,.517,35,44,.795,5,59,64,148,9,1,60,64,246
127,Matthew Dellavedova\dellama01,PG,28,MIL,12,0,97,6,19,.316,4,11,.364,2,8,.250,.421,4,4,1.000,0,10,10,29,2,0,11,9,20
127,Matthew Dellavedova\dellama01,PG,28,CLE,29,0,584,80,185,.432,35,98,.357,45,87,.517,.527,31,40,.775,5,49,54,119,7,1,49,55,226
128,Luol Deng\denglu01,SF,33,MIN,18,2,310,49,98,.500,12,37,.324,37,61,.607,.561,21,29,.724,19,45,64,13,11,6,10,17,131
129,DeMar DeRozan\derozde01,SG,29,SAS,54,54,1906,447,966,.463,7,41,.171,440,925,.476,.466,254,309,.822,42,289,331,331,54,26,142,123,1155
130,Marcus Derrickson\derrima01,PF,22,GSW,9,0,54,10,24,.417,5,14,.357,5,10,.500,.521,3,4,.750,5,3,8,1,0,1,3,9,28
131,Cheick Diallo\diallch01,PF,22,NOP,41,0,459,77,128,.602,0,2,.000,77,126,.611,.602,29,42,.690,40,117,157,14,15,22,26,53,183
132,Hamidou Diallo\diallha01,SG,20,OKC,45,3,515,75,161,.466,4,23,.174,71,138,.514,.478,36,59,.610,37,57,94,17,20,10,23,75,190
133,Gorgui Dieng\dienggo01,C,29,MIN,57,0,762,124,251,.494,13,42,.310,111,209,.531,.520,58,66,.879,59,174,233,50,31,29,35,107,319
134,Spencer Dinwiddie\dinwisp01,PG,25,BRK,49,4,1399,275,596,.461,96,262,.366,179,334,.536,.542,198,249,.795,21,100,121,246,28,11,114,136,844
135,Donte DiVincenzo\divindo01,SG,22,MIL,23,0,358,42,107,.393,17,69,.246,25,38,.658,.472,9,11,.818,13,43,56,27,12,6,18,34,110
136,Luka Doncic\doncilu01,SG,19,DAL,55,55,1772,377,877,.430,134,385,.348,243,492,.494,.506,252,349,.722,61,334,395,307,57,15,178,102,1140
137,Tyler Dorsey\dorsety01,SG,22,TOT,28,0,261,36,95,.379,11,42,.262,25,53,.472,.437,16,26,.615,10,35,45,18,8,1,10,21,99
137,Tyler Dorsey\dorsety01,SG,22,ATL,27,0,251,32,89,.360,10,39,.256,22,50,.440,.416,16,26,.615,9,34,43,17,7,1,10,20,90
137,Tyler Dorsey\dorsety01,G,22,MEM,1,0,10,4,6,.667,1,3,.333,3,3,1.000,.750,0,0,,1,1,2,1,1,0,0,1,9
138,Damyean Dotson\dotsoda01,SG,24,NYK,49,16,1212,172,408,.422,68,186,.366,104,222,.468,.505,45,63,.714,28,142,170,69,42,6,36,89,457
139,PJ Dozier\doziepj01,SG,22,BOS,4,0,10,3,6,.500,1,2,.500,2,4,.500,.583,0,0,,2,2,4,0,0,0,0,1,7
140,Goran Dragic\dragigo01,PG,32,MIA,14,14,408,77,188,.410,22,70,.314,55,118,.466,.468,38,50,.760,8,35,43,68,10,4,35,30,214
141,Andre Drummond\drumman01,C,25,DET,53,53,1748,386,733,.527,4,33,.121,382,700,.546,.529,147,262,.561,271,524,795,62,86,91,123,180,923
142,Jared Dudley\dudleja01,PF,33,BRK,43,25,944,77,190,.405,39,121,.322,38,69,.551,.508,22,35,.629,25,95,120,65,28,13,37,105,215
143,Kris Dunn\dunnkr01,PG,24,CHI,31,29,970,152,350,.434,19,56,.339,133,294,.452,.461,40,51,.784,9,122,131,200,46,16,79,113,363
144,Kevin Durant\duranke01,PF,30,GSW,57,57,2017,554,1074,.516,105,286,.367,449,788,.570,.565,360,403,.893,30,368,398,336,45,62,176,111,1573
145,Trevon Duval\duvaltr01,PG,20,MIL,3,0,6,2,3,.667,1,1,1.000,1,2,.500,.833,0,0,,0,1,1,2,0,0,0,0,5
146,Vince Edwards\edwarvi01,SF,22,HOU,2,0,16,1,4,.250,1,4,.250,0,0,,.375,0,0,,1,1,2,0,0,0,0,0,3
147,Henry Ellenson\ellenhe01,PF,22,DET,2,0,25,4,10,.400,2,4,.500,2,6,.333,.500,2,2,1.000,0,9,9,1,0,0,0,2,12
148,Wayne Ellington\ellinwa01,SG,31,TOT,27,12,585,75,204,.368,60,172,.349,15,32,.469,.515,14,16,.875,6,46,52,32,26,3,16,46,224
148,Wayne Ellington\ellinwa01,SG,31,MIA,25,12,533,69,184,.375,57,155,.368,12,29,.414,.530,14,16,.875,6,41,47,29,24,3,14,40,209
148,Wayne Ellington\ellinwa01,SG,31,DET,2,0,52,6,20,.300,3,17,.176,3,3,1.000,.375,0,0,,0,5,5,3,2,0,2,6,15
149,Joel Embiid\embiijo01,C,24,PHI,54,54,1822,483,1002,.482,64,217,.295,419,785,.534,.514,443,546,.811,134,594,728,188,32,105,194,182,1473
150,James Ennis\ennisja01,SF,28,TOT,43,25,988,107,222,.482,46,126,.365,61,96,.635,.586,42,58,.724,37,85,122,31,39,16,23,116,302
150,James Ennis\ennisja01,SF,28,HOU,40,25,949,104,211,.493,44,120,.367,60,91,.659,.597,42,58,.724,37,80,117,27,38,16,23,111,294
150,James Ennis\ennisja01,SF,28,PHI,3,0,39,3,11,.273,2,6,.333,1,5,.200,.364,0,0,,0,5,5,4,1,0,0,5,8
151,Drew Eubanks\eubandr01,PF,21,SAS,15,0,73,14,19,.737,0,0,,14,19,.737,.737,9,11,.818,1,15,16,3,1,2,4,7,37
152,Jacob Evans\evansja02,SG,21,GSW,23,0,99,6,25,.240,1,6,.167,5,19,.263,.260,0,1,.000,1,8,9,13,1,1,6,13,13
153,Jawun Evans\evansja01,PG,22,PHO,7,0,64,3,13,.231,0,2,.000,3,11,.273,.231,0,0,,1,11,12,10,3,0,6,8,6
154,Tyreke Evans\evansty01,SG,29,IND,51,15,1039,191,491,.389,62,170,.365,129,321,.402,.452,86,112,.768,26,114,140,124,48,12,89,86,530
155,Dante Exum\exumda01,PG,23,UTA,39,1,637,101,234,.432,18,59,.305,83,175,.474,.470,68,86,.791,15,50,65,107,14,5,46,63,288
156,Kenneth Faried\farieke01,C,29,TOT,24,11,480,105,170,.618,3,11,.273,102,159,.642,.626,39,66,.591,64,103,167,15,11,16,23,52,252
156,Kenneth Faried\farieke01,C,29,BRK,12,0,118,25,42,.595,1,5,.200,24,37,.649,.607,10,16,.625,15,29,44,2,2,4,6,8,61
156,Kenneth Faried\farieke01,C,29,HOU,12,11,362,80,128,.625,2,6,.333,78,122,.639,.633,29,50,.580,49,74,123,13,9,12,17,44,191
157,Derrick Favors\favorde01,C,27,UTA,56,50,1292,247,434,.569,14,62,.226,233,372,.626,.585,109,167,.653,147,248,395,59,42,75,59,121,617
158,Cristiano Felicio\feliccr01,C,26,CHI,36,0,367,45,82,.549,0,2,.000,45,80,.563,.549,25,37,.676,35,65,100,18,5,4,16,31,115
159,Raymond Felton\feltora01,PG,34,OKC,17,0,210,37,90,.411,10,37,.270,27,53,.509,.467,10,11,.909,3,20,23,33,8,4,11,16,94
160,Terrance Ferguson\fergute01,SG,20,OKC,49,49,1198,123,282,.436,69,180,.383,54,102,.529,.559,17,26,.654,23,66,89,39,29,12,26,154,332
161,Yogi Ferrell\ferreyo01,PG,25,SAC,47,3,708,105,234,.449,37,98,.378,68,136,.500,.528,36,41,.878,10,65,75,96,25,4,21,37,283
162,Dorian Finney-Smith\finnedo01,SF,25,DAL,57,18,1440,167,365,.458,60,174,.345,107,191,.560,.540,52,76,.684,103,167,270,49,58,27,57,134,446
163,Bryn Forbes\forbebr01,PG,25,SAS,59,58,1684,264,592,.446,127,303,.419,137,289,.474,.553,54,60,.900,12,159,171,127,37,3,67,126,709
164,Evan Fournier\fournev01,SG,26,ORL,58,58,1825,329,765,.430,111,328,.338,218,437,.499,.503,98,124,.790,30,149,179,212,52,8,115,169,867
165,De'Aaron Fox\foxde01,PG,21,SAC,56,56,1760,346,750,.461,60,164,.366,286,586,.488,.501,209,288,.726,33,174,207,401,95,28,169,142,961
166,Melvin Frazier\frazime01,SG,22,ORL,7,0,32,6,14,.429,0,3,.000,6,11,.545,.429,0,0,,2,1,3,0,1,0,1,4,12
167,Tim Frazier\fraziti01,PG,28,NOP,47,17,909,88,195,.451,27,77,.351,61,118,.517,.521,32,41,.780,32,105,137,206,25,4,60,93,235
168,Channing Frye\fryech01,C,35,CLE,29,5,275,32,89,.360,24,60,.400,8,29,.276,.494,9,12,.750,4,39,43,16,5,4,10,35,97
169,Markelle Fultz\fultzma01,PG,20,PHI,19,15,427,65,155,.419,4,14,.286,61,141,.433,.432,21,37,.568,26,44,70,59,17,5,25,52,155
170,Danilo Gallinari\gallida01,SF,30,LAC,48,48,1472,271,602,.450,118,264,.447,153,338,.453,.548,239,265,.902,41,247,288,120,33,16,67,96,899
171,Langston Galloway\gallola01,SG,27,DET,54,4,1149,144,388,.371,83,255,.325,61,133,.459,.478,46,57,.807,33,92,125,57,25,5,18,84,417
172,Marc Gasol\gasolma01,C,34,TOT,56,53,1848,315,706,.446,77,222,.347,238,484,.492,.501,157,209,.751,59,415,474,253,65,67,124,152,864
172,Marc Gasol\gasolma01,C,34,MEM,53,53,1788,303,683,.444,76,221,.344,227,462,.491,.499,152,201,.756,56,399,455,248,60,63,119,147,834
172,Marc Gasol\gasolma01,C,34,TOR,3,0,60,12,23,.522,1,1,1.000,11,22,.500,.543,5,8,.625,3,16,19,5,5,4,5,5,30
173,Pau Gasol\gasolpa01,C,38,SAS,26,6,324,41,86,.477,5,10,.500,36,76,.474,.506,27,38,.711,20,102,122,49,5,14,14,27,114
174,Rudy Gay\gayru01,PF,32,SAS,48,45,1311,277,534,.519,54,124,.435,223,410,.544,.569,86,100,.860,45,265,310,127,41,29,81,125,694
175,Paul George\georgpa01,SF,28,OKC,56,56,2034,529,1169,.453,218,537,.406,311,632,.492,.546,329,393,.837,79,369,448,232,128,26,147,158,1605
176,Taj Gibson\gibsota01,PF,33,MIN,56,54,1402,237,422,.562,11,33,.333,226,389,.581,.575,98,131,.748,136,228,364,64,45,32,59,148,583
177,Harry Giles\gilesha01,PF,20,SAC,44,0,567,117,236,.496,0,5,.000,117,231,.506,.496,40,64,.625,43,105,148,56,26,14,53,113,274
178,Shai Gilgeous-Alexander\gilgesh01,PG,20,LAC,59,50,1524,229,489,.468,30,91,.330,199,398,.500,.499,108,134,.806,42,119,161,178,63,34,108,120,596
179,Rudy Gobert\goberru01,C,26,UTA,57,56,1800,320,489,.654,0,0,,320,489,.654,.654,226,344,.657,214,519,733,127,52,122,90,158,866
180,Brandon Goodwin\goodwbr01,PG,23,DEN,16,0,57,6,23,.261,2,6,.333,4,17,.235,.304,9,11,.818,1,2,3,14,0,0,3,7,23
181,Aaron Gordon\gordoaa01,PF,23,ORL,55,55,1841,324,727,.446,83,243,.342,241,484,.498,.503,136,186,.731,92,310,402,195,42,36,109,129,867
182,Eric Gordon\gordoer01,SG,30,HOU,45,31,1458,255,651,.392,123,384,.320,132,267,.494,.486,93,118,.788,15,100,115,92,24,20,65,101,726
183,Marcin Gortat\gortama01,C,34,LAC,47,43,751,99,186,.532,0,0,,99,186,.532,.532,35,48,.729,67,194,261,65,6,24,50,92,233
184,Devonte' Graham\grahade01,PG,23,CHO,31,3,403,48,130,.369,23,75,.307,25,55,.455,.458,16,22,.727,3,34,37,68,17,2,21,31,135
185,Treveon Graham\grahatr01,SG,25,BRK,20,14,455,37,111,.333,20,72,.278,17,39,.436,.423,14,18,.778,14,46,60,21,8,5,14,51,108
186,Jerami Grant\grantje01,PF,24,OKC,55,52,1774,272,523,.520,63,169,.373,209,354,.590,.580,112,163,.687,57,223,280,51,50,75,47,144,719
187,Jerian Grant\grantje02,PG,26,ORL,48,1,792,72,181,.398,29,89,.326,43,92,.467,.478,22,32,.688,16,66,82,132,39,4,45,66,195
188,Donte Grantham\grantdo01,SF,23,OKC,1,0,2,0,1,.000,0,1,.000,0,0,,.000,0,0,,0,0,0,0,0,0,0,0,0
189,Danny Green\greenda02,SG,31,TOR,57,57,1637,202,453,.446,128,304,.421,74,149,.497,.587,28,31,.903,48,187,235,79,51,43,52,131,560
190,Draymond Green\greendr01,PF,28,GSW,42,42,1308,115,271,.424,24,103,.233,91,168,.542,.469,42,58,.724,41,277,318,307,66,45,108,135,296
191,Gerald Green\greenge01,SG,33,HOU,53,0,1131,181,433,.418,119,330,.361,62,103,.602,.555,39,49,.796,24,117,141,30,18,21,38,100,520
192,JaMychal Green\greenja01,PF,28,TOT,44,4,960,159,324,.491,43,104,.413,116,220,.527,.557,63,80,.788,75,195,270,37,35,28,66,135,424
192,JaMychal Green\greenja01,PF,28,MEM,41,4,900,151,312,.484,38,96,.396,113,216,.523,.545,63,80,.788,72,180,252,36,33,26,64,123,403
192,JaMychal Green\greenja01,PF,28,LAC,3,0,60,8,12,.667,5,8,.625,3,4,.750,.875,0,0,,3,15,18,1,2,2,2,12,21
193,Jeff Green\greenje02,PF,32,WAS,56,30,1559,242,509,.475,88,235,.374,154,274,.562,.562,127,141,.901,50,202,252,114,27,29,75,122,699
194,Blake Griffin\griffbl01,PF,29,DET,54,54,1959,480,1002,.479,134,367,.365,346,635,.545,.546,324,427,.759,74,363,437,292,39,22,202,154,1418
195,Daniel Hamilton\hamilda02,SG,23,ATL,19,3,204,23,60,.383,8,23,.348,15,37,.405,.450,3,6,.500,10,37,47,22,6,1,16,19,57
196,Tim Hardaway\hardati02,SG,26,TOT,51,50,1642,311,798,.390,128,375,.341,183,423,.433,.470,208,245,.849,29,148,177,131,45,7,87,114,958
196,Tim Hardaway\hardati02,SG,26,NYK,46,46,1499,282,726,.388,117,337,.347,165,389,.424,.469,199,233,.854,26,135,161,122,42,6,81,106,880
196,Tim Hardaway\hardati02,SG,26,DAL,5,4,143,29,72,.403,11,38,.289,18,34,.529,.479,9,12,.750,3,13,16,9,3,1,6,8,78
197,James Harden\hardeja01,SG,29,HOU,54,54,2019,581,1316,.441,274,733,.374,307,583,.527,.546,540,620,.871,53,307,360,417,117,41,290,176,1976
198,Maurice Harkless\harklma01,SF,25,POR,37,30,791,90,197,.457,20,69,.290,70,128,.547,.508,21,32,.656,39,101,140,28,33,32,26,103,221
199,Montrezl Harrell\harremo01,C,25,LAC,59,4,1556,378,608,.622,1,9,.111,377,599,.629,.623,181,294,.616,139,255,394,106,55,83,84,181,938
200,Devin Harris\harride01,PG,35,DAL,45,0,673,91,224,.406,40,129,.310,51,95,.537,.496,61,81,.753,7,60,67,60,28,10,35,77,283
201,Gary Harris\harriga01,SG,24,DEN,32,27,956,174,409,.425,50,159,.314,124,250,.496,.487,75,92,.815,22,75,97,87,31,14,39,68,473
202,Joe Harris\harrijo01,SG,27,BRK,54,54,1626,272,543,.501,132,280,.471,140,263,.532,.622,72,84,.857,35,162,197,140,28,9,85,142,748
203,Tobias Harris\harrito02,PF-SF,26,TOT,59,59,2034,452,909,.497,120,279,.430,332,630,.527,.563,199,228,.873,40,420,460,164,41,26,112,135,1223
203,Tobias Harris\harrito02,PF,26,LAC,55,55,1903,424,855,.496,112,258,.434,312,597,.523,.561,192,219,.877,37,395,432,150,40,24,109,123,1152
203,Tobias Harris\harrito02,SF,26,PHI,4,4,131,28,54,.519,8,21,.381,20,33,.606,.593,7,9,.778,3,25,28,14,1,2,3,12,71
204,Andrew Harrison\harrian01,SG-PG,24,TOT,17,0,187,16,53,.302,5,25,.200,11,28,.393,.349,17,18,.944,6,14,20,24,4,2,12,34,54
204,Andrew Harrison\harrian01,PG,24,MEM,1,0,5,1,2,.500,0,1,.000,1,1,1.000,.500,0,0,,0,0,0,0,0,0,0,1,2
204,Andrew Harrison\harrian01,SG,24,CLE,10,0,144,12,39,.308,3,14,.214,9,25,.360,.346,16,16,1.000,4,11,15,17,4,2,10,26,43
204,Andrew Harrison\harrian01,SG,24,NOP,6,0,38,3,12,.250,2,10,.200,1,2,.500,.333,1,2,.500,2,3,5,7,0,0,2,7,9
205,Shaquille Harrison\harrish01,PG,25,CHI,49,0,842,95,242,.393,17,63,.270,78,179,.436,.428,48,77,.623,16,111,127,82,57,18,37,77,255
206,Josh Hart\hartjo01,SG,23,LAL,54,21,1425,164,402,.408,81,239,.339,83,163,.509,.509,49,72,.681,29,184,213,81,56,35,53,124,458
207,Isaiah Hartenstein\harteis01,PF,20,HOU,27,0,220,20,41,.488,2,6,.333,18,35,.514,.512,11,14,.786,21,26,47,14,7,12,13,56,53
208,Udonis Haslem\hasleud01,C,38,MIA,4,0,15,2,6,.333,0,2,.000,2,4,.500,.333,0,0,,1,5,6,0,0,0,2,3,4
209,Gordon Hayward\haywago01,PF,28,BOS,53,17,1379,210,479,.438,64,190,.337,146,289,.505,.505,109,128,.852,43,201,244,185,51,16,80,80,593
210,John Henson\hensojo01,C,28,MIL,14,0,188,31,67,.463,11,31,.355,20,36,.556,.545,6,10,.600,16,55,71,14,7,11,12,16,79
211,Juan Hernangomez\hernaju01,PF,23,DEN,54,25,1217,133,290,.459,64,164,.390,69,126,.548,.569,63,81,.778,62,182,244,46,24,22,33,75,393
212,Willy Hernangomez\hernawi01,C,24,CHO,45,2,617,120,233,.515,13,30,.433,107,203,.527,.543,75,111,.676,91,158,249,41,11,15,45,79,328
213,Mario Hezonja\hezonma01,SF,23,NYK,48,14,916,140,353,.397,33,119,.277,107,234,.457,.443,54,77,.701,21,156,177,49,45,6,56,83,367
214,Isaiah Hicks\hicksis01,PF,24,NYK,1,0,4,0,0,,0,0,,0,0,,,1,2,.500,0,0,0,1,0,0,0,0,1
215,Buddy Hield\hieldbu01,SG,26,SAC,57,57,1801,434,913,.475,195,434,.449,239,479,.499,.582,105,122,.861,74,218,292,132,29,21,108,139,1168
216,Haywood Highsmith\highsha01,SF,22,PHI,2,0,9,1,2,.500,1,2,.500,0,0,,.750,0,0,,0,1,1,2,0,0,0,0,3
217,Nene Hilario\hilarne01,C,36,HOU,28,2,380,43,78,.551,0,2,.000,43,76,.566,.551,22,31,.710,21,66,87,19,13,11,6,61,108
218,George Hill\hillge01,PG,32,TOT,45,13,1012,125,277,.451,37,110,.336,88,167,.527,.518,47,57,.825,30,81,111,103,42,7,38,80,334
218,George Hill\hillge01,PG,32,CLE,13,13,344,55,107,.514,13,28,.464,42,79,.532,.575,17,20,.850,12,15,27,36,12,1,20,35,140
218,George Hill\hillge01,PG,32,MIL,32,0,668,70,170,.412,24,82,.293,46,88,.523,.482,30,37,.811,18,66,84,67,30,6,18,45,194
219,Solomon Hill\hillso01,SF,27,NOP,35,15,712,50,129,.388,20,70,.286,30,59,.508,.465,19,27,.704,30,78,108,44,18,8,23,61,139
220,Aaron Holiday\holidaa01,PG,22,IND,37,0,438,73,191,.382,28,95,.295,45,96,.469,.455,30,34,.882,4,50,54,56,15,12,26,47,204
221,Jrue Holiday\holidjr01,SG,28,NOP,59,59,2145,478,1017,.470,98,308,.318,380,709,.536,.518,188,245,.767,71,228,299,469,94,51,187,130,1242
222,Justin Holiday\holidju01,SG,29,TOT,59,54,1923,213,572,.372,122,354,.345,91,218,.417,.479,65,73,.890,28,218,246,121,88,27,79,112,613
222,Justin Holiday\holidju01,SG,29,CHI,38,38,1325,151,394,.383,97,270,.359,54,124,.435,.506,41,46,.891,19,150,169,85,67,21,47,79,440
222,Justin Holiday\holidju01,SG,29,MEM,21,16,598,62,178,.348,25,84,.298,37,94,.394,.419,24,27,.889,9,68,77,36,21,6,32,33,173
223,John Holland\hollajo02,SF,30,CLE,1,0,1,0,0,,0,0,,0,0,,,0,0,,0,0,0,0,0,0,0,0,0
224,Rondae Hollis-Jefferson\holliro01,SF,24,BRK,48,21,1075,168,411,.409,9,45,.200,159,366,.434,.420,102,157,.650,66,192,258,80,33,23,54,94,447
225,Richaun Holmes\holmeri01,C,25,PHO,53,2,874,168,262,.641,0,0,,168,262,.641,.641,92,128,.719,87,153,240,44,30,61,39,140,428
226,Rodney Hood\hoodro01,SG,26,TOT,49,45,1326,210,478,.439,61,164,.372,149,314,.475,.503,105,115,.913,18,99,117,94,41,5,36,108,586
226,Rodney Hood\hoodro01,SG,26,CLE,45,45,1234,194,454,.427,55,152,.362,139,302,.460,.488,104,114,.912,18,94,112,92,38,5,36,101,547
226,Rodney Hood\hoodro01,SG,26,POR,4,0,92,16,24,.667,6,12,.500,10,12,.833,.792,1,1,1.000,0,5,5,2,3,0,0,7,39
227,Al Horford\horfoal01,C,32,BOS,48,48,1370,258,489,.528,55,149,.369,203,340,.597,.584,40,50,.800,91,235,326,191,43,69,76,93,611
228,Danuel House\houseda01,SF,25,HOU,25,12,620,71,155,.458,39,100,.390,32,55,.582,.584,45,55,.818,20,69,89,26,14,10,23,45,226
229,Dwight Howard\howardw01,C,33,WAS,9,9,230,43,69,.623,0,0,,43,69,.623,.623,29,48,.604,24,59,83,4,7,4,16,34,115
230,Kevin Huerter\huertke01,SG,20,ATL,54,38,1473,186,443,.420,95,244,.389,91,199,.457,.527,33,45,.733,41,134,175,152,47,19,86,109,500
231,Chandler Hutchison\hutchch01,SF,22,CHI,44,14,895,96,209,.459,14,50,.280,82,159,.516,.493,23,38,.605,31,154,185,34,23,6,25,59,229
232,Serge Ibaka\ibakase01,C,29,TOR,55,46,1584,365,692,.527,35,135,.259,330,557,.592,.553,113,145,.779,115,324,439,85,27,72,95,169,878
233,Andre Iguodala\iguodan01,SF,35,GSW,50,11,1176,113,226,.500,40,108,.370,73,118,.619,.588,33,53,.623,35,159,194,164,44,39,37,65,299
234,Ersan Ilyasova\ilyaser01,PF,31,MIL,45,3,797,107,247,.433,36,103,.350,71,144,.493,.506,35,40,.875,63,136,199,40,26,11,36,117,285
235,Joe Ingles\inglejo01,SF,31,UTA,57,57,1772,241,549,.439,116,315,.368,125,234,.534,.545,68,94,.723,18,198,216,282,75,12,128,134,666
236,Brandon Ingram\ingrabr01,SF,21,LAL,46,46,1538,301,622,.484,22,77,.286,279,545,.512,.502,159,241,.660,35,187,222,139,27,28,115,124,783
237,Kyrie Irving\irvinky01,PG,26,BOS,47,47,1526,420,843,.498,119,291,.409,301,552,.545,.569,149,172,.866,55,173,228,325,77,21,127,109,1108
238,Jonathan Isaac\isaacjo01,PF,21,ORL,53,42,1379,174,410,.424,47,164,.287,127,246,.516,.482,87,101,.861,65,218,283,54,44,71,56,105,482
239,Wesley Iwundu\iwundwe01,SF,24,ORL,45,12,768,75,183,.410,19,50,.380,56,133,.421,.462,61,76,.803,23,87,110,38,20,16,30,87,230
240,Demetrius Jackson\jacksde01,PG,24,PHI,6,0,39,8,15,.533,2,6,.333,6,9,.667,.600,4,4,1.000,2,1,3,5,2,0,1,4,22
241,Frank Jackson\jacksfr01,PG,20,NOP,44,7,669,102,238,.429,27,91,.297,75,147,.510,.485,31,40,.775,14,57,71,42,14,1,28,60,262
242,Jaren Jackson\jacksja02,PF,19,MEM,58,56,1515,298,589,.506,51,142,.359,247,447,.553,.549,151,197,.766,73,199,272,64,52,82,98,220,798
243,Josh Jackson\jacksjo02,SG,21,PHO,59,22,1426,253,604,.419,46,154,.299,207,450,.460,.457,106,159,.667,50,200,250,138,60,39,140,155,658
244,Justin Jackson\jacksju01,SF,23,TOT,56,3,1115,131,309,.424,57,165,.345,74,144,.514,.516,43,52,.827,25,122,147,70,24,13,23,68,362
244,Justin Jackson\jacksju01,SF,23,SAC,52,3,1083,125,295,.424,55,159,.346,70,136,.515,.517,41,50,.820,25,121,146,68,23,13,22,67,346
244,Justin Jackson\jacksju01,SF,23,DAL,4,0,32,6,14,.429,2,6,.333,4,8,.500,.500,2,2,1.000,0,1,1,2,1,0,1,1,16
245,Reggie Jackson\jacksre01,PG,28,DET,56,56,1629,287,694,.414,116,317,.366,171,377,.454,.497,144,165,.873,34,120,154,247,38,6,101,158,834
246,LeBron James\jamesle01,SF,34,LAL,39,39,1363,383,747,.513,81,228,.355,302,519,.582,.567,197,290,.679,37,300,337,298,52,25,135,65,1044
247,Amile Jefferson\jeffeam01,PF,25,ORL,5,0,20,1,4,.250,0,0,,1,4,.250,.250,4,4,1.000,2,5,7,0,1,0,0,3,6
248,John Jenkins\jenkijo01,SG,27,TOT,6,0,49,11,20,.550,5,11,.455,6,9,.667,.675,0,0,,2,4,6,4,0,0,2,0,27
248,John Jenkins\jenkijo01,SG,27,WAS,4,0,14,2,2,1.000,2,2,1.000,0,0,,1.500,0,0,,0,1,1,1,0,0,0,0,6
248,John Jenkins\jenkijo01,SG,27,NYK,2,0,35,9,18,.500,3,9,.333,6,9,.667,.583,0,0,,2,3,5,3,0,0,2,0,21
249,Jonas Jerebko\jerebjo01,PF,31,GSW,53,6,972,130,274,.474,53,148,.358,77,126,.611,.571,51,62,.823,62,184,246,80,17,10,35,108,364
250,Alize Johnson\johnsal02,PF,22,IND,11,0,32,2,10,.200,1,2,.500,1,8,.125,.250,1,4,.250,1,7,8,0,0,1,0,3,6
251,Amir Johnson\johnsam01,C,31,PHI,37,2,354,55,103,.534,9,24,.375,46,79,.582,.578,23,30,.767,26,69,95,45,11,8,33,72,142
252,James Johnson\johnsja01,PF,31,MIA,40,33,847,123,287,.429,38,108,.352,85,179,.475,.495,33,45,.733,16,113,129,95,27,19,54,82,317
253,Stanley Johnson\johnsst04,SF,22,TOT,51,7,993,136,361,.377,51,186,.274,85,175,.486,.447,41,51,.804,27,155,182,60,50,13,56,97,364
253,Stanley Johnson\johnsst04,SF,22,DET,48,7,961,133,349,.381,51,181,.282,82,168,.488,.454,41,51,.804,25,150,175,60,48,13,55,92,358
253,Stanley Johnson\johnsst04,SF,22,NOP,3,0,32,3,12,.250,0,5,.000,3,7,.429,.250,0,0,,2,5,7,0,2,0,1,5,6
254,Tyler Johnson\johnsty01,PG-SG,26,TOT,47,12,1209,177,428,.414,75,217,.346,102,211,.483,.501,63,90,.700,23,108,131,121,44,21,67,82,492
254,Tyler Johnson\johnsty01,PG,26,MIA,44,10,1123,171,401,.426,72,204,.353,99,197,.503,.516,61,88,.693,19,102,121,112,40,21,63,72,475
254,Tyler Johnson\johnsty01,SG,26,PHO,3,2,86,6,27,.222,3,13,.231,3,14,.214,.278,2,2,1.000,4,6,10,9,4,0,4,10,17
255,Wesley Johnson\johnswe01,SF,31,TOT,30,13,456,43,104,.413,23,61,.377,20,43,.465,.524,9,14,.643,12,50,62,20,14,10,15,55,118
255,Wesley Johnson\johnswe01,SF,31,NOP,26,13,377,35,88,.398,19,50,.380,16,38,.421,.506,6,9,.667,10,44,54,16,12,7,12,45,95
255,Wesley Johnson\johnswe01,SF,31,WAS,4,0,79,8,16,.500,4,11,.364,4,5,.800,.625,3,5,.600,2,6,8,4,2,3,3,10,23
256,Nikola Jokic\jokicni01,C,23,DEN,56,56,1767,430,852,.505,62,201,.308,368,651,.565,.541,220,259,.849,157,438,595,433,79,36,179,158,1142
257,Damian Jones\jonesda03,C,23,GSW,24,22,410,53,74,.716,0,0,,53,74,.716,.716,24,37,.649,31,44,75,28,12,25,16,63,130
258,Derrick Jones\jonesde02,SF,21,MIA,37,5,668,104,203,.512,19,52,.365,85,151,.563,.559,45,73,.616,67,95,162,18,30,26,25,72,272
259,Jalen Jones\jonesja04,SF,25,CLE,16,0,214,26,62,.419,10,28,.357,16,34,.471,.500,19,27,.704,11,23,34,7,9,2,8,27,81
260,Tyus Jones\jonesty01,PG,22,MIN,43,6,873,90,237,.380,22,74,.297,68,163,.417,.426,32,38,.842,13,59,72,170,54,3,27,39,234
261,DeAndre Jordan\jordade01,C,30,TOT,57,57,1736,238,367,.649,0,0,,238,367,.649,.649,153,223,.686,186,577,763,115,36,61,123,144,629
261,DeAndre Jordan\jordade01,C,30,DAL,50,50,1554,208,323,.644,0,0,,208,323,.644,.644,135,198,.682,161,525,686,99,33,53,111,125,551
261,DeAndre Jordan\jordade01,C,30,NYK,7,7,182,30,44,.682,0,0,,30,44,.682,.682,18,25,.720,25,52,77,16,3,8,12,19,78
262,Cory Joseph\josepco01,PG,27,IND,58,3,1493,177,400,.443,45,134,.336,132,266,.496,.499,21,32,.656,26,187,213,230,63,12,63,90,420
263,Frank Kaminsky\kaminfr01,C,25,CHO,26,0,281,49,102,.480,16,46,.348,33,56,.589,.559,22,35,.629,19,43,62,27,5,5,18,26,136
264,Enes Kanter\kanteen01,C,26,NYK,44,23,1128,251,468,.536,7,22,.318,244,446,.547,.544,105,129,.814,171,290,461,84,18,17,79,106,614
265,Luke Kennard\kennalu01,SG,22,DET,38,10,794,120,288,.417,53,145,.366,67,143,.469,.509,27,35,.771,8,100,108,57,14,7,31,51,320
266,Michael Kidd-Gilchrist\kiddgmi01,PF,25,CHO,50,1,984,137,287,.477,10,38,.263,127,249,.510,.495,88,113,.779,81,130,211,47,27,37,38,131,372
267,George King\kingge03,SF,25,PHO,1,0,6,0,0,,0,0,,0,0,,,0,0,,0,1,1,0,0,0,0,0,0
268,Maxi Kleber\klebima01,PF,27,DAL,52,15,1027,124,274,.453,53,158,.335,71,116,.612,.549,41,52,.788,62,148,210,40,28,61,37,98,342
269,Brandon Knight\knighbr03,PG,27,TOT,15,2,161,20,63,.317,11,43,.256,9,20,.450,.405,9,11,.818,1,12,13,17,3,0,9,15,60
269,Brandon Knight\knighbr03,PG,27,HOU,12,0,118,11,47,.234,5,32,.156,6,15,.400,.287,9,11,.818,1,8,9,9,2,0,5,14,36
269,Brandon Knight\knighbr03,PG,27,CLE,3,2,43,9,16,.563,6,11,.545,3,5,.600,.750,0,0,,0,4,4,8,1,0,4,1,24
270,Kevin Knox\knoxke01,PF,19,NYK,51,33,1437,225,618,.364,85,251,.339,140,367,.381,.433,100,139,.719,42,176,218,48,28,16,76,122,635
271,Furkan Korkmaz\korkmfu01,SG,21,PHI,46,6,654,94,234,.402,46,139,.331,48,95,.505,.500,35,42,.833,16,89,105,51,28,2,25,59,269
272,Luke Kornet\kornelu01,PF,23,NYK,29,11,461,69,176,.392,47,118,.398,22,58,.379,.526,23,27,.852,16,59,75,34,19,17,16,25,208
273,Kyle Korver\korveky01,SG-PF,37,TOT,51,0,954,148,334,.443,97,235,.413,51,99,.515,.588,47,57,.825,6,105,111,51,15,9,44,74,440
273,Kyle Korver\korveky01,PF,37,CLE,16,0,251,35,76,.461,25,54,.463,10,22,.455,.625,13,16,.813,0,29,29,17,3,2,17,22,108
273,Kyle Korver\korveky01,SG,37,UTA,35,0,703,113,258,.438,72,181,.398,41,77,.532,.578,34,41,.829,6,76,82,34,12,7,27,52,332
274,Kosta Koufos\koufoko01,C,29,SAC,31,1,379,53,109,.486,0,0,,53,109,.486,.486,6,17,.353,40,99,139,26,13,13,20,53,112
275,Rodions Kurucs\kurucro01,SF,20,BRK,41,29,856,138,301,.458,33,110,.300,105,191,.550,.513,50,57,.877,39,109,148,30,24,12,47,94,359
276,Kyle Kuzma\kuzmaky01,PF,23,LAL,53,51,1732,385,825,.467,104,326,.319,281,499,.563,.530,140,183,.765,45,252,297,124,34,19,106,120,1014
277,Skal Labissiere\labissk01,PF,22,TOT,14,0,114,13,30,.433,4,11,.364,9,19,.474,.500,6,11,.545,4,21,25,6,2,3,7,21,36
277,Skal Labissiere\labissk01,PF,22,SAC,13,0,113,13,30,.433,4,11,.364,9,19,.474,.500,6,11,.545,4,20,24,6,2,3,7,21,36
277,Skal Labissiere\labissk01,F,22,POR,1,0,1,0,0,,0,0,,0,0,,,0,0,,0,1,1,0,0,0,0,0,0
278,Jeremy Lamb\lambje01,SG,26,CHO,54,54,1544,300,678,.442,73,218,.335,227,460,.493,.496,146,169,.864,48,252,300,109,53,16,52,104,819
279,Zach LaVine\lavinza01,SG,23,CHI,51,50,1733,417,903,.462,88,252,.349,329,651,.505,.511,250,291,.859,28,201,229,223,48,20,168,113,1172
280,Jake Layman\laymaja01,SF,24,POR,46,25,840,150,277,.542,46,123,.374,104,154,.675,.625,27,37,.730,36,97,133,33,22,18,27,59,373
281,T.J. Leaf\leaftj01,PF,21,IND,37,0,297,55,100,.550,5,23,.217,50,77,.649,.575,9,16,.563,18,48,66,15,4,9,10,24,124
282,Courtney Lee\leeco01,SG,33,TOT,16,2,185,22,49,.449,5,17,.294,17,32,.531,.500,9,14,.643,6,22,28,17,10,2,6,16,58
282,Courtney Lee\leeco01,SG,33,NYK,12,2,160,21,47,.447,5,16,.313,16,31,.516,.500,9,14,.643,6,21,27,16,8,2,5,13,56
282,Courtney Lee\leeco01,SG,33,DAL,4,0,25,1,2,.500,0,1,.000,1,1,1.000,.500,0,0,,0,1,1,1,2,0,1,3,2
283,Damion Lee\leeda03,SG,26,GSW,18,0,215,32,71,.451,15,37,.405,17,34,.500,.556,12,15,.800,6,30,36,3,8,0,8,19,91
284,Alex Len\lenal01,C,25,ATL,54,20,1031,204,423,.482,31,99,.313,173,324,.534,.519,106,155,.684,117,187,304,55,20,51,80,138,545
285,Kawhi Leonard\leonaka01,SF,27,TOR,43,43,1495,398,809,.492,77,212,.363,321,597,.538,.540,286,331,.864,58,271,329,142,80,19,90,65,1159
286,Meyers Leonard\leoname01,C,26,POR,52,1,753,115,212,.542,47,100,.470,68,112,.607,.653,36,44,.818,41,161,202,63,13,9,37,89,313
287,Jon Leuer\leuerjo01,PF,29,DET,32,1,346,60,99,.606,0,9,.000,60,90,.667,.606,22,29,.759,22,65,87,12,12,4,22,52,142
288,Caris LeVert\leverca01,SF,24,BRK,17,15,485,110,240,.458,21,74,.284,89,166,.536,.502,45,63,.714,15,54,69,69,23,7,38,42,286
289,Damian Lillard\lillada01,PG,28,POR,56,56,1977,486,1080,.450,162,434,.373,324,646,.502,.525,340,375,.907,43,208,251,357,65,26,157,102,1474
290,Jeremy Lin\linje01,PG,30,TOT,52,1,1028,183,393,.466,44,135,.326,139,258,.539,.522,144,170,.847,16,108,124,186,39,8,101,97,554
290,Jeremy Lin\linje01,PG,30,ATL,51,1,1003,180,386,.466,44,132,.333,136,254,.535,.523,142,168,.845,16,103,119,181,38,7,98,96,546
290,Jeremy Lin\linje01,G,30,TOR,1,0,25,3,7,.429,0,3,.000,3,4,.750,.429,2,2,1.000,0,5,5,5,1,1,3,1,8
291,Shaun Livingston\livinsh01,PG,33,GSW,45,0,690,81,165,.491,0,2,.000,81,163,.497,.491,35,43,.814,31,58,89,85,24,23,26,55,197
292,Zach Lofton\loftoza01,SG,26,DET,1,0,4,0,1,.000,0,1,.000,0,0,,.000,0,0,,0,0,0,0,1,0,1,0,0
293,Kevon Looney\looneke01,C,22,GSW,57,23,1184,161,264,.610,1,10,.100,160,254,.630,.612,54,86,.628,148,186,334,102,34,47,38,160,377
294,Brook Lopez\lopezbr01,C,30,MIL,57,57,1588,248,546,.454,138,371,.372,110,175,.629,.581,58,71,.817,21,220,241,62,32,118,57,128,692
295,Robin Lopez\lopezro01,C,30,CHI,50,12,889,156,282,.553,5,20,.250,151,262,.576,.562,42,61,.689,70,82,152,46,9,48,64,90,359
296,Kevin Love\loveke01,PF,30,CLE,6,6,158,26,80,.325,9,33,.273,17,47,.362,.381,33,39,.846,10,54,64,16,1,1,13,15,94
297,Kyle Lowry\lowryky01,PG,32,TOR,47,47,1615,221,539,.410,110,326,.337,111,213,.521,.512,122,146,.836,30,180,210,432,65,25,130,125,674
298,Jordan Loyd\loydjo01,PG,25,TOR,8,0,36,5,11,.455,2,5,.400,3,6,.500,.545,4,5,.800,1,6,7,2,0,0,2,5,16
299,Kalin Lucas\lucaska01,PG,29,DET,1,0,6,0,1,.000,0,1,.000,0,0,,.000,2,2,1.000,0,3,3,1,0,0,0,1,2
300,Timothe Luwawu-Cabarrot\luwawti01,SF-SG,23,TOT,26,1,206,23,75,.307,11,40,.275,12,35,.343,.380,11,14,.786,5,27,32,5,6,2,7,25,68
300,Timothe Luwawu-Cabarrot\luwawti01,SF,23,OKC,21,1,123,13,43,.302,5,22,.227,8,21,.381,.360,4,6,.667,4,14,18,4,4,1,5,14,35
300,Timothe Luwawu-Cabarrot\luwawti01,SG,23,CHI,5,0,83,10,32,.313,6,18,.333,4,14,.286,.406,7,8,.875,1,13,14,1,2,1,2,11,33
301,Tyler Lydon\lydonty01,PF,22,DEN,21,0,87,8,17,.471,4,10,.400,4,7,.571,.588,1,3,.333,6,10,16,5,2,0,4,10,21
302,Trey Lyles\lylestr01,PF,23,DEN,55,1,1024,193,456,.423,46,181,.254,147,275,.535,.474,75,108,.694,41,182,223,77,28,23,61,85,507
303,Shelvin Mack\macksh01,PG,28,TOT,55,3,1228,162,396,.409,46,128,.359,116,268,.433,.467,57,82,.695,18,86,104,183,47,4,63,84,427
303,Shelvin Mack\macksh01,PG,28,MEM,53,3,1204,161,389,.414,46,128,.359,115,261,.441,.473,53,75,.707,18,84,102,182,45,4,62,81,421
303,Shelvin Mack\macksh01,PG,28,CHO,2,0,24,1,7,.143,0,0,,1,7,.143,.143,4,7,.571,0,2,2,1,2,0,1,3,6
304,Daryl Macon\maconda01,SG,23,DAL,4,0,8,2,2,1.000,0,0,,2,2,1.000,1.000,0,0,,0,0,0,0,1,0,1,0,4
305,J.P. Macura\macurjp01,SG,23,CHO,1,0,14,2,8,.250,0,4,.000,2,4,.500,.250,0,0,,0,2,2,2,0,0,0,0,4
306,Ian Mahinmi\mahinia01,C,32,WAS,31,6,445,41,83,.494,1,12,.083,40,71,.563,.500,41,60,.683,39,68,107,24,24,15,20,75,124
307,Thon Maker\makerth01,C-PF,21,TOT,38,0,450,62,145,.428,27,84,.321,35,61,.574,.521,24,41,.585,20,84,104,19,10,20,13,60,175
307,Thon Maker\makerth01,C,21,MIL,35,0,409,59,134,.440,26,78,.333,33,56,.589,.537,20,37,.541,17,79,96,18,10,18,9,55,164
307,Thon Maker\makerth01,PF,21,DET,3,0,41,3,11,.273,1,6,.167,2,5,.400,.318,4,4,1.000,3,5,8,1,0,2,4,5,11
308,Boban Marjanovic\marjabo01,C,30,TOT,40,9,428,98,158,.620,0,3,.000,98,155,.632,.620,74,97,.763,59,110,169,27,11,20,42,63,270
308,Boban Marjanovic\marjabo01,C,30,LAC,36,9,376,85,140,.607,0,2,.000,85,138,.616,.607,72,95,.758,55,97,152,22,11,17,37,57,242
308,Boban Marjanovic\marjabo01,C,30,PHI,4,0,52,13,18,.722,0,1,.000,13,17,.765,.722,2,2,1.000,4,13,17,5,0,3,5,6,28
309,Lauri Markkanen\markkla01,PF,21,CHI,35,34,1131,230,526,.437,88,230,.383,142,296,.480,.521,99,113,.876,44,263,307,45,27,25,57,81,647
310,Jarell Martin\martija01,PF,24,ORL,32,1,254,35,81,.432,15,39,.385,20,42,.476,.525,7,8,.875,7,45,52,14,2,7,11,35,92
311,Frank Mason\masonfr01,PG,24,SAC,34,0,395,59,142,.415,11,50,.220,48,92,.522,.454,36,53,.679,4,34,38,82,16,4,30,29,165
312,Wesley Matthews\matthwe02,SF-SG,32,TOT,48,47,1427,202,505,.400,105,283,.371,97,222,.437,.504,96,120,.800,22,91,113,110,35,13,61,111,605
312,Wesley Matthews\matthwe02,SF,32,DAL,44,44,1312,194,469,.414,100,263,.380,94,206,.456,.520,87,110,.791,20,82,102,100,33,12,58,102,575
312,Wesley Matthews\matthwe02,SG,32,NYK,2,1,54,4,19,.211,2,10,.200,2,9,.222,.263,4,5,.800,1,2,3,5,1,1,2,2,14
312,Wesley Matthews\matthwe02,SG,32,IND,2,2,61,4,17,.235,3,10,.300,1,7,.143,.324,5,5,1.000,1,7,8,5,1,0,1,7,16
313,Luc Mbah a Moute\mbahalu01,PF,32,LAC,4,0,61,8,18,.444,2,6,.333,6,12,.500,.500,2,5,.400,2,5,7,2,1,1,2,8,20
314,Patrick McCaw\mccawpa01,SG,23,TOT,13,0,165,9,28,.321,2,13,.154,7,15,.467,.357,6,6,1.000,6,19,25,11,10,1,10,16,26
314,Patrick McCaw\mccawpa01,SG,23,CLE,3,0,53,2,9,.222,1,4,.250,1,5,.200,.278,0,0,,0,3,3,2,2,0,3,1,5
314,Patrick McCaw\mccawpa01,SG,23,TOR,10,0,112,7,19,.368,1,9,.111,6,10,.600,.395,6,6,1.000,6,16,22,9,8,1,7,15,21
315,CJ McCollum\mccolcj01,SG,27,POR,56,56,1903,460,1006,.457,127,351,.362,333,655,.508,.520,129,155,.832,49,175,224,154,46,20,87,133,1176
316,T.J. McConnell\mccontj01,PG,26,PHI,52,1,1076,157,283,.555,12,34,.353,145,249,.582,.576,20,26,.769,20,97,117,199,65,14,68,85,346
317,Doug McDermott\mcderdo01,SF,27,IND,53,0,918,125,269,.465,58,150,.387,67,119,.563,.572,47,54,.870,10,61,71,44,11,6,28,71,355
318,JaVale McGee\mcgeeja01,C,31,LAL,50,40,1083,245,406,.603,1,8,.125,244,398,.613,.605,66,104,.635,119,224,343,36,31,99,72,127,557
319,Rodney McGruder\mcgruro01,SG,27,MIA,51,44,1290,160,398,.402,67,191,.351,93,207,.449,.486,40,53,.755,44,147,191,99,29,8,59,102,427
320,Alfonzo McKinnie\mckinal01,SF,26,GSW,48,1,678,96,196,.490,28,80,.350,68,116,.586,.561,16,31,.516,61,108,169,19,10,10,22,92,236
321,Ben McLemore\mclembe01,SG,25,SAC,19,0,158,25,64,.391,17,41,.415,8,23,.348,.523,8,12,.667,3,14,17,4,6,3,5,22,75
322,Jordan McRae\mcraejo01,SG,27,WAS,19,0,172,33,66,.500,8,15,.533,25,51,.490,.561,7,12,.583,4,17,21,11,6,5,9,12,81
323,Salah Mejri\mejrisa01,C,32,DAL,17,2,115,16,29,.552,0,2,.000,16,27,.593,.552,7,8,.875,13,26,39,7,3,3,4,16,39
324,De'Anthony Melton\meltode01,PG,20,PHO,33,25,675,71,193,.368,24,77,.312,47,116,.405,.430,15,18,.833,16,70,86,110,50,17,55,85,181
325,Chimezie Metu\metuch01,PF,21,SAS,26,0,135,17,54,.315,0,2,.000,17,52,.327,.315,13,17,.765,9,25,34,13,6,2,13,12,47
326,Khris Middleton\middlkh01,SF,27,MIL,54,54,1679,329,755,.436,122,323,.378,207,432,.479,.517,143,169,.846,28,287,315,227,58,5,120,121,923
327,C.J. Miles\milescj01,SF,31,TOT,43,1,630,84,235,.357,48,152,.316,36,83,.434,.460,37,46,.804,12,64,76,28,18,10,23,66,253
327,C.J. Miles\milescj01,SF,31,TOR,40,1,562,70,206,.340,43,137,.314,27,69,.391,.444,35,44,.795,12,56,68,22,18,10,21,62,218
327,C.J. Miles\milescj01,SF,31,MEM,3,0,68,14,29,.483,5,15,.333,9,14,.643,.569,2,2,1.000,0,8,8,6,0,0,2,4,35
328,Darius Miller\milleda01,SF,28,NOP,54,15,1373,144,370,.389,106,284,.373,38,86,.442,.532,36,43,.837,9,88,97,99,34,21,41,132,430
329,Patty Mills\millspa02,PG,30,SAS,59,1,1404,206,470,.438,113,277,.408,93,193,.482,.559,70,82,.854,19,118,137,182,41,9,68,90,595
330,Paul Millsap\millspa01,PF,33,DEN,46,41,1181,207,423,.489,32,91,.352,175,332,.527,.527,116,160,.725,95,212,307,87,57,39,60,113,562
331,Shake Milton\miltosh01,SG,22,PHI,13,0,126,20,46,.435,10,25,.400,10,21,.476,.543,4,5,.800,7,13,20,13,4,3,3,14,54
332,Nikola Mirotic\mirotni01,PF,27,NOP,32,22,925,182,407,.447,85,231,.368,97,176,.551,.552,85,101,.842,46,218,264,35,21,25,37,86,534
333,Donovan Mitchell\mitchdo01,SG,22,UTA,53,53,1765,435,1040,.418,115,357,.322,320,683,.469,.474,204,257,.794,37,170,207,211,81,18,145,143,1189
334,Naz Mitrou-Long\mitrona01,SG,25,UTA,10,0,39,2,8,.250,1,6,.167,1,2,.500,.313,0,0,,0,2,2,4,0,0,3,5,5
335,Malik Monk\monkma01,SG,20,CHO,54,0,997,194,489,.397,88,264,.333,106,225,.471,.487,79,88,.898,11,85,96,97,28,14,70,77,555
336,Greg Monroe\monrogr01,C,28,TOR,38,2,423,74,161,.460,0,4,.000,74,157,.471,.460,35,61,.574,60,96,156,16,13,8,31,61,183
337,E'Twaun Moore\mooreet01,SF,29,NOP,47,36,1353,237,486,.488,67,155,.432,170,331,.514,.557,38,50,.760,34,82,116,94,35,8,55,103,579
338,Eric Moreland\moreler01,PF,27,PHO,1,0,5,0,0,,0,0,,0,0,,,0,0,,0,3,3,0,0,0,0,1,0
339,Jaylen Morris\morrija01,SG,23,MIL,4,0,29,4,10,.400,1,3,.333,3,7,.429,.450,1,2,.500,0,5,5,4,2,0,1,1,10
340,Marcus Morris\morrima03,PF,29,BOS,53,36,1467,281,590,.476,110,269,.409,171,321,.533,.569,99,114,.868,49,273,322,75,32,17,68,130,771
341,Markieff Morris\morrima02,PF,29,WAS,34,15,883,143,328,.436,48,144,.333,95,184,.516,.509,57,73,.781,41,133,174,60,25,20,47,117,391
342,Monte Morris\morrimo01,PG,23,DEN,57,5,1424,252,507,.497,69,160,.431,183,347,.527,.565,43,55,.782,25,126,151,223,52,2,35,72,616
343,Johnathan Motley\motlejo01,PF,23,LAC,15,0,122,29,59,.492,0,3,.000,29,56,.518,.492,18,29,.621,15,21,36,7,4,2,13,18,76
344,Emmanuel Mudiay\mudiaem01,PG,22,NYK,39,32,1036,219,483,.453,41,133,.308,178,350,.509,.496,95,125,.760,25,95,120,152,31,13,83,70,574
345,Jamal Murray\murraja01,PG,21,DEN,51,50,1707,351,816,.430,100,272,.368,251,544,.461,.491,129,153,.843,47,169,216,254,41,19,122,107,931
346,Dzanan Musa\musadz01,SG,19,BRK,8,0,34,8,20,.400,0,9,.000,8,11,.727,.400,0,2,.000,1,3,4,1,2,0,4,1,16
347,Mike Muscala\muscami01,PF,27,TOT,48,6,1054,112,285,.393,70,204,.343,42,81,.519,.516,63,77,.818,51,150,201,64,18,27,43,113,357
347,Mike Muscala\muscami01,PF,27,PHI,47,6,1041,109,278,.392,68,199,.342,41,79,.519,.514,63,77,.818,51,149,200,62,18,27,43,112,349
347,Mike Muscala\muscami01,PF,27,LAL,1,0,13,3,7,.429,2,5,.400,1,2,.500,.571,0,0,,0,1,1,2,0,0,0,1,8
348,Sviatoslav Mykhailiuk\mykhasv01,SF-SG,21,TOT,40,0,429,45,136,.331,28,87,.322,17,49,.347,.434,12,20,.600,8,27,35,35,13,1,21,25,130
348,Sviatoslav Mykhailiuk\mykhasv01,SF,21,LAL,39,0,420,44,132,.333,27,85,.318,17,47,.362,.436,12,20,.600,8,26,34,33,13,1,20,25,127
348,Sviatoslav Mykhailiuk\mykhasv01,SG,21,DET,1,0,9,1,4,.250,1,2,.500,0,2,.000,.375,0,0,,0,1,1,2,0,0,1,0,3
349,Abdel Nader\naderab01,SF,25,OKC,38,1,385,58,125,.464,17,48,.354,41,77,.532,.532,14,19,.737,7,60,67,10,9,3,15,42,147
350,Larry Nance\nancela02,C,26,CLE,48,20,1257,171,335,.510,21,56,.375,150,279,.538,.542,72,100,.720,123,274,397,146,66,33,65,139,435
351,Shabazz Napier\napiesh01,PG,27,BRK,47,2,849,145,370,.392,65,185,.351,80,185,.432,.480,106,129,.822,14,73,87,123,39,15,57,57,461
352,Raul Neto\netora01,PG,26,UTA,22,1,263,42,81,.519,10,31,.323,32,50,.640,.580,17,20,.850,2,29,31,48,8,0,20,25,111
353,Georges Niang\niangge01,PF,25,UTA,42,0,312,46,104,.442,29,71,.408,17,33,.515,.582,10,13,.769,7,47,54,21,7,3,13,37,131
354,Joakim Noah\noahjo01,C,33,MEM,29,0,416,60,120,.500,0,0,,60,120,.500,.500,33,50,.660,37,98,135,45,13,17,29,56,153
355,Nerlens Noel\noelne01,C,24,OKC,53,2,764,117,203,.576,0,0,,117,203,.576,.576,37,50,.740,94,157,251,31,53,71,32,119,271
356,Dirk Nowitzki\nowitdi01,PF,40,DAL,26,0,286,44,124,.355,25,81,.309,19,43,.442,.456,10,12,.833,0,45,45,8,4,8,8,33,123
357,Frank Ntilikina\ntilila01,PG,20,NYK,41,16,872,94,275,.342,32,110,.291,62,165,.376,.400,21,28,.750,10,72,82,116,30,14,54,100,241
358,James Nunnally\nunnaja01,SF,28,TOT,15,0,102,12,34,.353,8,25,.320,4,9,.444,.471,4,4,1.000,0,5,5,7,1,0,1,10,36
358,James Nunnally\nunnaja01,SF,28,MIN,13,0,64,9,21,.429,5,13,.385,4,8,.500,.548,4,4,1.000,0,4,4,5,1,0,1,4,27
358,James Nunnally\nunnaja01,SF,28,HOU,2,0,38,3,13,.231,3,12,.250,0,1,.000,.346,0,0,,0,1,1,2,0,0,0,6,9
359,Jusuf Nurkic\nurkiju01,C,24,POR,56,56,1529,316,631,.501,3,25,.120,313,606,.517,.503,206,275,.749,191,380,571,178,58,85,127,193,841
360,David Nwaba\nwabada01,SG,26,CLE,27,11,496,64,141,.454,13,44,.295,51,97,.526,.500,38,60,.633,23,65,88,23,17,8,15,50,179
361,Royce O'Neale\onealro01,SF,25,UTA,57,9,1068,112,227,.493,47,107,.439,65,120,.542,.597,27,36,.750,18,172,190,76,38,16,49,107,298
362,Kyle O'Quinn\oquinky01,C,28,IND,32,0,223,36,81,.444,1,11,.091,35,70,.500,.451,9,10,.900,17,54,71,32,3,18,21,42,82
363,Semi Ojeleye\ojelese01,PF,24,BOS,40,2,429,50,116,.431,21,68,.309,29,48,.604,.522,15,22,.682,17,46,63,16,8,3,13,31,136
364,Jahlil Okafor\okafoja01,C,23,NOP,38,13,570,131,218,.601,0,1,.000,131,217,.604,.601,40,56,.714,62,119,181,21,11,25,30,68,302
365,Elie Okobo\okoboel01,PG,21,PHO,41,11,775,90,237,.380,29,105,.276,61,132,.462,.441,29,35,.829,8,73,81,107,25,5,56,93,238
366,Josh Okogie\okogijo01,SG,20,MIN,49,27,1112,126,346,.364,39,150,.260,87,196,.444,.421,79,106,.745,29,119,148,57,48,18,49,115,370
367,Victor Oladipo\oladivi01,SG,26,IND,36,36,1147,249,588,.423,74,216,.343,175,372,.470,.486,103,141,.730,21,181,202,186,60,11,82,72,675
368,Kelly Olynyk\olynyke01,PF,27,MIA,53,10,1077,156,345,.452,73,215,.340,83,130,.638,.558,93,118,.788,49,182,231,90,31,21,78,117,478
369,Cedi Osman\osmande01,SF,23,CLE,52,51,1633,239,562,.425,80,245,.327,159,317,.502,.496,98,130,.754,29,212,241,118,39,9,85,135,656
370,Kelly Oubre\oubreke01,SF,23,TOT,57,7,1540,285,650,.438,85,271,.314,200,379,.528,.504,150,192,.781,55,202,257,65,59,48,76,148,805
370,Kelly Oubre\oubreke01,SF,23,WAS,29,7,755,132,305,.433,41,132,.311,91,173,.526,.500,68,85,.800,24,105,129,20,27,20,30,71,373
370,Kelly Oubre\oubreke01,SF,23,PHO,28,0,785,153,345,.443,44,139,.317,109,206,.529,.507,82,107,.766,31,97,128,45,32,28,46,77,432
371,Zaza Pachulia\pachuza01,C,34,DET,46,3,665,66,146,.452,0,4,.000,66,142,.465,.452,77,100,.770,85,126,211,65,29,15,40,109,209
372,Jabari Parker\parkeja01,PF,23,TOT,43,17,1154,240,503,.477,39,126,.310,201,377,.533,.516,86,119,.723,44,227,271,105,28,17,94,96,605
372,Jabari Parker\parkeja01,PF,23,CHI,39,17,1042,220,464,.474,37,114,.325,183,350,.523,.514,79,108,.731,41,200,241,84,23,14,84,87,556
372,Jabari Parker\parkeja01,PF,23,WAS,4,0,112,20,39,.513,2,12,.167,18,27,.667,.538,7,11,.636,3,27,30,21,5,3,10,9,49
373,Tony Parker\parketo01,PG,36,CHO,46,0,837,175,383,.457,9,40,.225,166,343,.484,.469,81,111,.730,11,56,67,177,17,5,60,47,440
374,Chandler Parsons\parsoch01,SF,30,MEM,3,3,46,7,17,.412,3,10,.300,4,7,.571,.500,0,0,,1,3,4,2,1,1,2,7,17
375,Patrick Patterson\pattepa01,PF,29,OKC,57,5,839,82,217,.378,46,136,.338,36,81,.444,.484,19,30,.633,41,101,142,31,16,13,21,43,229
376,Chris Paul\paulch01,PG,33,HOU,34,34,1106,176,420,.419,71,202,.351,105,218,.482,.504,108,130,.831,19,122,141,272,71,9,94,86,531
377,Cameron Payne\payneca01,PG,24,TOT,40,13,712,96,223,.430,25,84,.298,71,139,.511,.487,33,41,.805,13,59,72,106,28,9,45,64,250
377,Cameron Payne\payneca01,PG,24,CHI,31,12,536,69,168,.411,16,59,.271,53,109,.486,.458,22,25,.880,10,43,53,83,20,6,34,49,176
377,Cameron Payne\payneca01,PG,24,CLE,9,1,176,27,55,.491,9,25,.360,18,30,.600,.573,11,16,.688,3,16,19,23,8,3,11,15,74
378,Elfrid Payton\paytoel01,PG,24,NOP,19,19,512,75,171,.439,13,37,.351,62,134,.463,.477,23,31,.742,14,56,70,111,22,5,45,37,186
379,Gary Payton\paytoga02,PG,26,WAS,3,0,16,5,8,.625,1,2,.500,4,6,.667,.688,0,0,,1,1,2,4,3,1,1,2,11
380,Theo Pinson\pinsoth01,SG,23,BRK,11,0,161,18,52,.346,8,30,.267,10,22,.455,.423,15,16,.938,2,27,29,17,4,0,14,11,59
381,Mason Plumlee\plumlma01,C,28,DEN,57,16,1176,192,311,.617,1,6,.167,191,305,.626,.619,79,146,.541,119,223,342,152,51,52,90,182,464
382,Miles Plumlee\plumlmi01,C,30,ATL,18,0,173,32,48,.667,0,0,,32,48,.667,.667,16,30,.533,16,23,39,17,6,4,10,14,80
383,Jakob Poeltl\poeltja01,C,23,SAS,55,8,814,123,192,.641,0,0,,123,192,.641,.641,38,68,.559,114,145,259,68,13,35,39,85,284
384,Quincy Pondexter\pondequ01,SF,30,SAS,43,0,247,24,49,.490,6,18,.333,18,31,.581,.551,27,35,.771,7,33,40,22,9,1,10,21,81
385,Otto Porter\porteot01,SF,25,TOT,45,32,1330,238,500,.476,76,195,.390,162,305,.531,.552,56,73,.767,48,206,254,89,67,24,48,88,608
385,Otto Porter\porteot01,SF,25,WAS,41,28,1191,202,442,.457,65,176,.369,137,266,.515,.531,49,64,.766,40,191,231,80,64,22,40,79,518
385,Otto Porter\porteot01,SF,25,CHI,4,4,139,36,58,.621,11,19,.579,25,39,.641,.716,7,9,.778,8,15,23,9,3,2,8,9,90
386,Bobby Portis\portibo01,PF,23,TOT,26,6,648,152,327,.465,39,94,.415,113,233,.485,.524,43,56,.768,50,140,190,37,15,10,36,74,386
386,Bobby Portis\portibo01,PF,23,CHI,22,6,531,122,271,.450,27,72,.375,95,199,.477,.500,39,50,.780,46,115,161,29,11,8,29,61,310
386,Bobby Portis\portibo01,PF,23,WAS,4,0,117,30,56,.536,12,22,.545,18,34,.529,.643,4,6,.667,4,25,29,8,4,2,7,13,76
387,Dwight Powell\poweldw01,C,27,DAL,53,0,927,164,283,.580,18,74,.243,146,209,.699,.611,114,151,.755,72,160,232,53,26,31,42,129,460
388,Norman Powell\powelno01,SG,25,TOR,37,3,695,115,243,.473,37,106,.349,78,137,.569,.549,43,53,.811,9,63,72,60,25,8,32,63,310
389,Alex Poythress\poythal01,PF,25,ATL,18,1,243,35,65,.538,7,18,.389,28,47,.596,.592,11,21,.524,24,35,59,13,3,8,10,39,88
390,Zhou Qi\qizh01,PF,23,HOU,1,0,1,1,1,1.000,0,0,,1,1,1.000,1.000,0,0,,0,0,0,0,0,0,0,0,2
391,Ivan Rabb\rabbiv01,PF,21,MEM,29,5,320,60,98,.612,1,4,.250,59,94,.628,.617,23,36,.639,37,65,102,21,7,7,19,40,144
392,Chasson Randle\randlch01,PG,25,WAS,28,2,437,56,127,.441,27,62,.435,29,65,.446,.547,26,40,.650,7,29,36,60,13,1,32,59,165
393,Julius Randle\randlju01,C,24,NOP,52,28,1536,381,705,.540,37,108,.343,344,597,.576,.567,249,337,.739,111,364,475,155,33,33,137,177,1048
394,J.J. Redick\redicjj01,SG,34,PHI,54,41,1683,335,740,.453,168,425,.395,167,315,.530,.566,164,181,.906,16,104,120,150,22,11,78,96,1002
395,Davon Reed\reedda01,SG,23,IND,7,0,20,2,4,.500,1,1,1.000,1,3,.333,.625,0,0,,1,1,2,2,0,0,1,1,5
396,Josh Richardson\richajo01,SG,25,MIA,54,54,1872,329,788,.418,133,352,.378,196,436,.450,.502,158,183,.863,39,153,192,211,59,27,96,154,949
397,Malachi Richardson\richama01,SG,23,TOR,22,0,103,9,29,.310,8,25,.320,1,4,.250,.448,4,5,.800,2,11,13,0,1,0,8,13,30
398,Austin Rivers\riverau01,SG-PG,26,TOT,53,15,1481,172,426,.404,79,246,.321,93,180,.517,.496,40,74,.541,21,108,129,134,32,17,55,152,463
398,Austin Rivers\riverau01,SG,26,WAS,29,2,683,76,194,.392,33,106,.311,43,88,.489,.477,25,46,.543,11,60,71,58,18,10,36,72,210
398,Austin Rivers\riverau01,PG,26,HOU,24,13,798,96,232,.414,46,140,.329,50,92,.543,.513,15,28,.536,10,48,58,76,14,7,19,80,253
399,Devin Robinson\robinde01,SF,23,WAS,4,0,32,8,13,.615,0,0,,8,13,.615,.615,3,6,.500,2,5,7,2,3,1,0,2,19
400,Duncan Robinson\robindu01,PF,24,MIA,6,0,36,3,8,.375,2,7,.286,1,1,1.000,.500,0,0,,0,7,7,0,1,0,0,1,8
401,Glenn Robinson\robingl02,SF,25,DET,32,17,438,46,120,.383,13,43,.302,33,77,.429,.438,27,33,.818,10,31,41,13,11,5,17,30,132
402,Jerome Robinson\robinje01,SG,21,LAC,23,0,218,29,73,.397,14,40,.350,15,33,.455,.493,4,6,.667,3,22,25,8,7,2,3,35,76
403,Mitchell Robinson\robinmi01,C,20,NYK,42,12,750,112,161,.696,0,0,,112,161,.696,.696,34,66,.515,99,98,197,23,30,89,20,126,258
404,Rajon Rondo\rondora01,PG,32,LAL,23,9,644,86,194,.443,22,52,.423,64,142,.451,.500,11,20,.550,19,98,117,174,20,4,59,58,205
405,Derrick Rose\rosede01,PG,30,MIN,41,13,1169,292,612,.477,53,132,.402,239,480,.498,.520,111,130,.854,26,87,113,195,26,11,68,45,748
406,Terrence Ross\rosste01,SG,27,ORL,59,0,1550,321,739,.434,144,378,.381,177,361,.490,.532,78,91,.857,20,175,195,91,52,23,58,89,864
407,Terry Rozier\roziete01,PG,24,BOS,57,10,1326,185,482,.384,88,242,.364,97,240,.404,.475,58,71,.817,26,212,238,182,54,16,51,72,516
408,Ricky Rubio\rubiori01,PG,28,UTA,50,49,1437,229,561,.408,67,208,.322,162,353,.459,.468,125,148,.845,22,161,183,304,65,9,145,135,650
409,D'Angelo Russell\russeda01,PG,22,BRK,58,58,1746,454,1041,.436,159,427,.372,295,614,.480,.512,108,131,.824,33,186,219,385,65,16,172,99,1175
410,Domantas Sabonis\sabondo01,C,22,IND,56,5,1386,312,515,.606,8,14,.571,304,501,.607,.614,155,208,.745,138,378,516,153,38,24,122,177,787
411,Brandon Sampson\sampsbr01,SG,21,CHI,4,0,28,5,7,.714,2,4,.500,3,3,1.000,.857,0,0,,0,4,4,1,0,0,0,3,12
412,Dario Saric\saricda01,PF,24,TOT,56,16,1391,202,467,.433,81,220,.368,121,247,.490,.519,85,96,.885,86,233,319,86,31,6,65,128,570
412,Dario Saric\saricda01,PF,24,PHI,13,13,396,48,132,.364,21,70,.300,27,62,.435,.443,27,30,.900,21,65,86,26,4,3,25,39,144
412,Dario Saric\saricda01,PF,24,MIN,43,3,995,154,335,.460,60,150,.400,94,185,.508,.549,58,66,.879,65,168,233,60,27,3,40,89,426
413,Tomas Satoransky\satorto01,SG,27,WAS,56,30,1374,164,336,.488,43,99,.434,121,237,.511,.552,75,95,.789,50,129,179,242,54,10,70,115,446
414,Dennis Schroder\schrode01,PG,25,OKC,54,10,1527,320,752,.426,82,228,.360,238,524,.454,.480,128,156,.821,22,159,181,220,50,8,125,123,850
415,Mike Scott\scottmi01,PF,30,TOT,56,0,818,99,250,.396,55,144,.382,44,106,.415,.506,12,19,.632,25,153,178,47,19,9,27,95,265
415,Mike Scott\scottmi01,PF,30,LAC,52,0,748,92,230,.400,52,133,.391,40,97,.412,.513,12,18,.667,24,150,174,44,17,8,27,88,248
415,Mike Scott\scottmi01,PF,30,PHI,4,0,70,7,20,.350,3,11,.273,4,9,.444,.425,0,1,.000,1,3,4,3,2,1,0,7,17
416,Thabo Sefolosha\sefolth01,SF,34,UTA,27,0,292,29,59,.492,13,29,.448,16,30,.533,.602,8,14,.571,4,69,73,10,23,2,15,23,79
417,Wayne Selden\seldewa01,SG,24,TOT,51,5,865,115,277,.415,39,106,.368,76,171,.444,.486,40,53,.755,22,59,81,65,17,7,47,84,309
417,Wayne Selden\seldewa01,SG,24,MEM,32,0,455,65,161,.404,20,63,.317,45,98,.459,.466,22,29,.759,16,28,44,36,10,6,23,48,172
417,Wayne Selden\seldewa01,SG,24,CHI,19,5,410,50,116,.431,19,43,.442,31,73,.425,.513,18,24,.750,6,31,37,29,7,1,24,36,137
418,Collin Sexton\sextoco01,PG,20,CLE,58,48,1766,334,818,.408,62,158,.392,272,660,.412,.446,143,169,.846,44,135,179,167,30,3,129,141,873
419,Landry Shamet\shamela01,SG-PG,21,TOT,57,5,1192,165,371,.445,108,261,.414,57,110,.518,.590,51,62,.823,16,68,84,68,28,8,29,110,489
419,Landry Shamet\shamela01,SG,21,PHI,54,4,1108,153,347,.441,99,245,.404,54,102,.529,.584,44,54,.815,14,64,78,59,24,8,26,106,449
419,Landry Shamet\shamela01,PG,21,LAC,3,1,84,12,24,.500,9,16,.563,3,8,.375,.688,7,8,.875,2,4,6,9,4,0,3,4,40
420,Iman Shumpert\shumpim01,SG,28,TOT,45,40,1168,137,365,.375,78,218,.358,59,147,.401,.482,34,41,.829,21,115,136,96,50,21,40,100,386
420,Iman Shumpert\shumpim01,SG,28,SAC,42,40,1099,133,348,.382,74,202,.366,59,146,.404,.489,34,41,.829,19,110,129,91,47,20,38,92,374
420,Iman Shumpert\shumpim01,SG,28,HOU,3,0,69,4,17,.235,4,16,.250,0,1,.000,.353,0,0,,2,5,7,5,3,1,2,8,12
421,Pascal Siakam\siakapa01,PF,24,TOR,58,57,1828,360,653,.551,47,138,.341,313,515,.608,.587,169,214,.790,95,312,407,164,56,39,105,176,936
422,Ben Simmons\simmobe01,PG,22,PHI,57,57,1928,384,673,.571,0,3,.000,384,670,.573,.571,187,319,.586,124,389,513,450,75,42,204,140,955
423,Jonathon Simmons\simmojo02,SG-SF,29,TOT,44,9,877,108,292,.370,21,86,.244,87,206,.422,.406,59,75,.787,23,80,103,99,20,14,57,72,296
423,Jonathon Simmons\simmojo02,SG,29,ORL,41,9,845,104,286,.364,19,83,.229,85,203,.419,.397,56,72,.778,23,77,100,95,18,14,56,68,283
423,Jonathon Simmons\simmojo02,SF,29,PHI,3,0,32,4,6,.667,2,3,.667,2,3,.667,.833,3,3,1.000,0,3,3,4,2,0,1,4,13
424,Kobi Simmons\simmoko01,PG,21,CLE,1,0,2,0,0,,0,0,,0,0,,,0,0,,0,0,0,0,0,0,0,0,0
425,Anfernee Simons\simonan01,SG,19,POR,12,0,60,7,25,.280,0,9,.000,7,16,.438,.280,1,4,.250,0,7,7,4,0,0,7,3,15
426,Marcus Smart\smartma01,SG,24,BOS,57,37,1540,157,391,.402,90,251,.359,67,140,.479,.517,71,91,.780,38,124,162,234,96,23,82,142,475
427,Dennis Smith\smithde03,PG,21,TOT,39,39,1126,201,460,.437,50,151,.331,151,309,.489,.491,81,126,.643,24,92,116,180,52,14,116,103,533
427,Dennis Smith\smithde03,PG,21,DAL,32,32,908,157,357,.440,43,125,.344,114,232,.491,.500,57,82,.695,18,79,97,138,40,11,100,82,414
427,Dennis Smith\smithde03,PG,21,NYK,7,7,218,44,103,.427,7,26,.269,37,77,.481,.461,24,44,.545,6,13,19,42,12,3,16,21,119
428,Ish Smith\smithis01,PG,30,DET,30,0,668,98,250,.392,32,91,.352,66,159,.415,.456,18,24,.750,5,56,61,87,13,8,33,62,246
429,J.R. Smith\smithjr01,SG,33,CLE,11,4,222,27,79,.342,12,39,.308,15,40,.375,.418,8,10,.800,0,18,18,21,11,3,11,19,74
430,Jason Smith\smithja02,C-PF,32,TOT,18,1,170,19,50,.380,7,19,.368,12,31,.387,.450,12,14,.857,14,34,48,13,3,7,12,27,57
430,Jason Smith\smithja02,C,32,WAS,12,1,130,15,37,.405,4,10,.400,11,27,.407,.459,10,12,.833,11,26,37,12,1,5,7,21,44
430,Jason Smith\smithja02,PF,32,MIL,6,0,40,4,13,.308,3,9,.333,1,4,.250,.423,2,2,1.000,3,8,11,1,2,2,5,6,13
431,Tony Snell\snellto01,SG,27,MIL,57,8,984,127,276,.460,64,159,.403,63,117,.538,.576,33,37,.892,21,92,113,50,21,13,19,62,351
432,Ray Spalding\spaldra01,PF,21,DAL,1,0,1,0,0,,0,0,,0,0,,,0,0,,0,0,0,0,0,0,0,0,0
433,Omari Spellman\spellom01,PF,21,ATL,41,10,706,85,216,.394,41,116,.353,44,100,.440,.488,30,42,.714,62,106,168,38,24,23,26,60,241
434,Nik Stauskas\stausni01,SG,25,TOT,46,0,716,99,242,.409,45,134,.336,54,108,.500,.502,34,38,.895,11,74,85,63,15,5,42,36,277
434,Nik Stauskas\stausni01,SG,25,POR,44,0,673,96,229,.419,43,125,.344,53,104,.510,.513,32,36,.889,10,70,80,62,14,4,40,31,267
434,Nik Stauskas\stausni01,SG,25,CLE,2,0,43,3,13,.231,2,9,.222,1,4,.250,.308,2,2,1.000,1,4,5,1,1,1,2,5,10
435,D.J. Stephens\stephdj01,SG,28,MEM,1,0,7,1,2,.500,0,0,,1,2,.500,.500,0,0,,0,0,0,0,1,0,1,0,2
436,Lance Stephenson\stephla01,SG,28,LAL,56,0,902,159,361,.440,62,162,.383,97,199,.487,.526,42,63,.667,26,140,166,115,35,5,74,92,422
437,Edmond Sumner\sumneed01,PG,23,IND,17,2,167,16,49,.327,4,20,.200,12,29,.414,.367,5,12,.417,7,12,19,7,9,5,8,21,41
438,Caleb Swanigan\swanica01,PF,21,POR,18,0,145,14,44,.318,1,5,.200,13,39,.333,.330,6,7,.857,13,39,52,7,4,0,16,22,35
439,Jayson Tatum\tatumja01,SF,20,BOS,58,58,1807,352,777,.453,92,243,.379,260,534,.487,.512,160,186,.860,57,308,365,110,60,48,86,127,956
440,Jeff Teague\teaguje01,PG,30,MIN,34,33,1028,142,331,.429,30,84,.357,112,247,.453,.474,101,124,.815,12,74,86,277,37,13,77,70,415
441,Garrett Temple\templga01,SG,32,TOT,52,51,1589,174,403,.432,77,219,.352,97,184,.527,.527,60,81,.741,20,137,157,72,51,26,56,142,485
441,Garrett Temple\templga01,SG,32,MEM,49,49,1530,166,387,.429,74,210,.352,92,177,.520,.525,57,76,.750,18,134,152,69,50,25,54,134,463
441,Garrett Temple\templga01,SG,32,LAC,3,2,59,8,16,.500,3,9,.333,5,7,.714,.594,3,5,.600,2,3,5,3,1,1,2,8,22
442,Milos Teodosic\teodomi01,PG,31,LAC,15,0,150,17,40,.425,10,27,.370,7,13,.538,.550,4,7,.571,3,13,16,32,3,1,21,27,48
443,Jared Terrell\terreja01,SG,23,MIN,7,0,67,8,26,.308,4,11,.364,4,15,.267,.385,1,2,.500,1,2,3,7,3,1,7,8,21
444,Emanuel Terry\terryem01,PF,22,PHO,2,0,20,4,6,.667,0,0,,4,6,.667,.667,1,2,.500,2,4,6,1,3,0,2,4,9
445,Daniel Theis\theisda01,C,26,BOS,44,2,669,115,199,.578,23,50,.460,92,149,.617,.636,46,62,.742,65,109,174,51,15,28,24,116,299
446,Isaiah Thomas\thomais02,G,29,DEN,1,0,13,3,6,.500,2,5,.400,1,1,1.000,.667,0,0,,0,0,0,2,0,0,2,3,8
447,Khyri Thomas\thomakh01,SG,22,DET,17,0,152,17,46,.370,10,27,.370,7,19,.368,.478,6,9,.667,3,11,14,5,5,4,3,14,50
448,Lance Thomas\thomala01,PF,30,NYK,26,11,428,36,93,.387,8,37,.216,28,56,.500,.430,19,23,.826,11,52,63,13,16,6,13,52,99
449,Klay Thompson\thompkl01,SG,28,GSW,56,56,1910,478,1019,.469,166,419,.396,312,600,.520,.551,102,126,.810,24,199,223,123,63,38,86,120,1224
450,Tristan Thompson\thomptr01,C,27,CLE,35,35,1043,173,329,.526,0,0,,173,329,.526,.526,55,85,.647,154,235,389,75,28,16,50,81,401
451,Sindarius Thornwell\thornsi01,SG,24,LAC,41,1,245,15,41,.366,2,13,.154,13,28,.464,.390,16,23,.696,4,32,36,14,11,3,18,36,48
452,Anthony Tolliver\tollian01,PF,33,MIN,40,0,591,50,126,.397,41,110,.373,9,16,.563,.560,21,28,.750,11,76,87,20,12,12,20,53,162
453,Karl-Anthony Towns\townska01,C,23,MIN,57,57,1888,479,935,.512,100,257,.389,379,678,.559,.566,261,308,.847,192,494,686,184,53,101,165,211,1319
454,Gary Trent\trentga02,SG,20,POR,8,0,34,5,18,.278,3,8,.375,2,10,.200,.361,1,4,.250,0,4,4,1,0,1,1,1,14
455,Allonzo Trier\trieral01,SG,23,NYK,51,3,1124,171,383,.446,35,90,.389,136,293,.464,.492,130,156,.833,24,128,152,99,21,14,92,84,507
456,P.J. Tucker\tuckepj01,PF,33,HOU,57,57,2015,151,385,.392,98,271,.362,53,114,.465,.519,33,51,.647,91,268,359,73,92,26,49,178,433
457,Evan Turner\turneev01,PG,30,POR,56,2,1321,177,380,.466,7,46,.152,170,334,.509,.475,60,85,.706,33,226,259,222,28,14,94,91,421
458,Myles Turner\turnemy01,C,22,IND,53,53,1495,286,562,.509,50,123,.407,236,439,.538,.553,93,129,.721,70,300,370,87,39,145,73,136,715
459,Ekpe Udoh\udohek01,C,31,UTA,35,0,192,28,39,.718,0,0,,28,39,.718,.718,10,16,.625,12,28,40,14,4,17,8,23,66
460,Tyler Ulis\ulisty01,PG,23,CHI,1,0,1,0,0,,0,0,,0,0,,,0,0,,0,0,0,0,0,0,0,0,0
461,Jonas Valanciunas\valanjo01,C,26,TOT,32,10,608,164,284,.577,9,32,.281,155,252,.615,.593,82,102,.804,57,176,233,36,13,24,43,88,419
461,Jonas Valanciunas\valanjo01,C,26,TOR,30,10,564,149,259,.575,9,30,.300,140,229,.611,.593,77,94,.819,54,162,216,29,13,23,39,82,384
461,Jonas Valanciunas\valanjo01,C,26,MEM,2,0,44,15,25,.600,0,2,.000,15,23,.652,.600,5,8,.625,3,14,17,7,0,1,4,6,35
462,Jarred Vanderbilt\vandeja01,PF,19,DEN,3,0,14,0,4,.000,0,0,,0,4,.000,.000,1,2,.500,2,9,11,1,2,1,1,0,1
463,Fred VanVleet\vanvlfr01,PG,24,TOR,51,22,1369,189,469,.403,85,232,.366,104,237,.439,.494,75,90,.833,20,118,138,234,45,12,65,90,538
464,Noah Vonleh\vonleno01,PF,23,NYK,58,48,1483,169,376,.449,43,126,.341,126,250,.504,.507,95,131,.725,99,368,467,111,43,47,74,149,476
465,Nikola Vucevic\vucevni01,C,28,ORL,58,58,1802,503,965,.521,65,171,.380,438,794,.552,.555,120,154,.779,155,544,699,222,54,66,116,111,1191
466,Dwyane Wade\wadedw01,SG,37,MIA,46,0,1169,244,564,.433,54,167,.323,190,397,.479,.480,101,145,.697,42,131,173,197,30,22,104,74,643
467,Moritz Wagner\wagnemo01,C,21,LAL,22,0,146,26,61,.426,12,30,.400,14,31,.452,.525,9,15,.600,8,25,33,9,5,3,11,17,73
468,Dion Waiters\waitedi01,SG,27,MIA,18,4,406,69,169,.408,36,104,.346,33,65,.508,.515,4,12,.333,2,39,41,48,10,2,21,17,178
469,Kemba Walker\walkeke02,PG,28,CHO,57,57,1962,491,1140,.431,187,517,.362,304,623,.488,.513,253,305,.830,32,217,249,320,72,27,143,89,1422
470,Lonnie Walker\walkelo01,SG,20,SAS,6,0,57,4,21,.190,2,6,.333,2,15,.133,.238,4,4,1.000,0,10,10,2,3,1,4,3,14
471,John Wall\walljo01,PG,28,WAS,32,32,1104,245,552,.444,51,169,.302,194,383,.507,.490,122,175,.697,15,101,116,279,49,29,121,71,663
472,Tyrone Wallace\wallaty01,PG,24,LAC,44,0,459,71,167,.425,2,14,.143,69,153,.451,.431,22,45,.489,18,54,72,26,18,7,21,58,166
473,Taurean Waller-Prince\princta02,SF,24,ATL,37,29,1021,175,398,.440,82,215,.381,93,183,.508,.543,62,74,.838,17,120,137,70,37,14,73,96,494
474,Brad Wanamaker\wanambr01,PG,29,BOS,27,0,250,34,72,.472,16,31,.516,18,41,.439,.583,14,15,.933,2,25,27,37,9,1,14,19,98
475,T.J. Warren\warretj01,SF,25,PHO,43,36,1360,297,611,.486,77,180,.428,220,431,.510,.549,101,124,.815,31,143,174,64,51,29,52,119,772
476,Julian Washburn\washbju01,SF,27,MEM,6,2,110,3,19,.158,1,8,.125,2,11,.182,.184,3,4,.750,4,16,20,3,4,0,3,5,10
477,Yuta Watanabe\watanyu01,SG,24,MEM,10,0,98,10,28,.357,2,9,.222,8,19,.421,.393,7,10,.700,1,18,19,4,2,1,4,3,29
478,Thomas Welsh\welshth01,C,22,DEN,9,0,33,5,10,.500,3,7,.429,2,3,.667,.650,1,2,.500,0,4,4,4,0,0,1,2,14
479,Russell Westbrook\westbru01,PG,30,OKC,49,49,1744,402,963,.417,57,229,.249,345,734,.470,.447,202,308,.656,71,478,549,548,108,21,226,167,1063
480,Derrick White\whitede01,PG,24,SAS,45,33,1138,167,334,.500,31,87,.356,136,247,.551,.546,67,87,.770,22,132,154,163,45,23,67,95,432
481,Okaro White\whiteok01,PF,26,WAS,3,0,6,0,2,.000,0,2,.000,0,0,,.000,0,0,,1,1,2,0,0,0,0,0,0
482,Hassan Whiteside\whiteha01,C,29,MIA,50,50,1268,277,504,.550,2,15,.133,275,489,.562,.552,84,193,.435,188,431,619,43,35,105,80,136,640
483,Andrew Wiggins\wiggian01,SF,23,MIN,51,51,1772,337,850,.396,79,239,.331,258,611,.422,.443,160,224,.714,63,182,245,122,55,31,96,103,913
484,Alan Williams\willial03,PF,26,BRK,3,0,17,4,8,.500,0,1,.000,4,7,.571,.500,2,4,.500,3,11,14,2,0,0,1,2,10
485,C.J. Williams\willicj01,SG,28,MIN,9,0,67,7,17,.412,1,7,.143,6,10,.600,.441,0,0,,1,3,4,6,1,0,4,11,15
486,Johnathan Williams\willijo04,C,23,LAL,7,0,89,11,20,.550,0,0,,11,20,.550,.550,1,5,.200,11,10,21,4,1,4,2,20,23
487,Kenrich Williams\willike04,SF,24,NOP,23,6,399,47,107,.439,18,52,.346,29,55,.527,.523,8,13,.615,21,79,100,30,5,9,13,37,120
488,Lou Williams\willilo02,SG,32,LAC,53,0,1382,339,790,.429,74,199,.372,265,591,.448,.476,301,336,.896,21,132,153,282,33,8,128,55,1053
489,Marvin Williams\willima02,PF,32,CHO,56,56,1584,209,495,.422,112,299,.375,97,196,.495,.535,48,66,.727,52,262,314,68,51,41,28,121,578
490,Robert Williams\williro04,C,21,BOS,23,0,200,28,38,.737,0,0,,28,38,.737,.737,6,10,.600,19,36,55,5,6,32,8,28,62
491,Troy Williams\willitr02,SF,24,SAC,18,0,286,40,87,.460,14,41,.341,26,46,.565,.540,9,15,.600,9,46,55,10,10,8,8,34,103
492,D.J. Wilson\wilsodj01,PF,22,MIL,29,0,529,62,143,.434,27,72,.375,35,71,.493,.528,11,28,.393,25,106,131,28,12,18,18,55,162
493,Justise Winslow\winslju01,PF,22,MIA,51,38,1515,242,574,.422,73,197,.371,169,377,.448,.485,73,113,.646,51,227,278,211,50,15,112,131,630
494,Christian Wood\woodch01,PF,23,MIL,11,0,52,10,22,.455,2,4,.500,8,18,.444,.500,10,13,.769,4,14,18,2,0,0,2,2,32
495,Delon Wright\wrighde01,PG,26,TOT,52,3,981,136,315,.432,32,99,.323,104,216,.481,.483,56,65,.862,39,97,136,123,50,17,40,58,360
495,Delon Wright\wrighde01,PG,26,TOR,49,2,897,127,293,.433,30,90,.333,97,203,.478,.485,53,61,.869,39,86,125,110,46,15,37,53,337
495,Delon Wright\wrighde01,PG,26,MEM,3,1,84,9,22,.409,2,9,.222,7,13,.538,.455,3,4,.750,0,11,11,13,4,2,3,5,23
496,Guerschon Yabusele\yabusgu01,PF,23,BOS,29,0,164,21,47,.447,4,17,.235,17,30,.567,.489,9,12,.750,15,18,33,12,7,7,11,27,55
497,Nick Young\youngni01,SG,33,DEN,4,0,37,3,9,.333,3,8,.375,0,1,.000,.500,0,0,,0,1,1,2,0,1,2,4,9
498,Thaddeus Young\youngth01,PF,30,IND,58,58,1752,318,598,.532,31,87,.356,287,511,.562,.558,59,95,.621,139,231,370,126,91,26,78,136,726
499,Trae Young\youngtr01,PG,20,ATL,58,58,1743,337,831,.406,100,321,.312,237,510,.465,.466,206,258,.798,39,154,193,442,51,13,229,97,980
500,Cody Zeller\zelleco01,C,26,CHO,40,38,995,147,265,.555,5,19,.263,142,246,.577,.564,84,106,.792,93,173,266,85,30,31,49,127,383
501,Ante Zizic\zizican01,C,22,CLE,41,12,671,109,210,.519,0,0,,109,210,.519,.519,58,79,.734,66,141,207,27,10,15,34,75,276
502,Ivica Zubac\zubaciv01,C,21,TOT,36,15,576,122,212,.575,0,0,,122,212,.575,.575,68,79,.861,55,124,179,27,4,31,39,81,312
502,Ivica Zubac\zubaciv01,C,21,LAL,33,12,516,112,193,.580,0,0,,112,193,.580,.580,57,66,.864,54,108,162,25,4,27,33,73,281
502,Ivica Zubac\zubaciv01,C,21,LAC,3,3,60,10,19,.526,0,0,,10,19,.526,.526,11,13,.846,1,16,17,2,0,4,6,8,31